Date,Kind,Model,Max Mode,Input (w/ Cache Write),Input (w/o Cache Write),Cache Read,Output Tokens,Total Tokens,Cost
"2025-09-26T02:21:30.238Z","Included","auto","No","406","88022","90926","327","179681","0.14"
"2025-09-26T02:20:31.131Z","Included","auto","No","386","87575","90541","279","178781","0.13"
"2025-09-26T02:19:58.226Z","Included","auto","No","483","87141","90059","287","177970","0.13"
"2025-09-26T02:17:38.540Z","Included","auto","No","548","86601","89512","400","177061","0.13"
"2025-09-26T02:17:17.448Z","Included","auto","No","572","86013","88941","461","175987","0.13"
"2025-09-26T02:16:34.324Z","Included","auto","No","517","85399","88425","475","174816","0.13"
"2025-09-26T02:15:35.436Z","Included","auto","No","44873","36988","1096148","1057","1179066","0.38"
"2025-09-26T02:15:03.816Z","Included","auto","No","50802","103932","863759","723","1019216","0.41"
"2025-09-26T02:14:48.026Z","Included","auto","No","16649","85379","168881","393","271302","0.17"
"2025-09-26T02:13:22.021Z","Included","auto","No","15493","67427","137856","391","221167","0.14"
"2025-09-26T02:11:57.036Z","Included","auto","No","444","66986","68282","323","136035","0.10"
"2025-09-26T02:10:59.035Z","Included","auto","No","360","66518","67923","353","135154","0.10"
"2025-09-26T02:10:43.187Z","Included","auto","No","394","66119","67530","275","134318","0.10"
"2025-09-26T02:10:26.841Z","Included","auto","No","375","65704","67156","304","133539","0.10"
"2025-09-26T02:10:03.391Z","Included","auto","No","339","65306","66818","289","132752","0.10"
"2025-09-26T02:08:31.218Z","Included","auto","No","55715","221720","11104","9509","298048","0.41"
"2025-09-26T02:08:08.286Z","Included","auto","No","514","82744","108779","102","192139","0.13"
"2025-09-26T02:07:43.424Z","Included","auto","No","487","82191","108293","411","191382","0.13"
"2025-09-26T02:05:48.275Z","Included","auto","No","498","81668","107796","401","190363","0.13"
"2025-09-26T01:57:00.856Z","Included","auto","No","3545","78131","529142","1366","612184","0.24"
"2025-09-26T01:55:20.049Z","Included","auto","No","4209","74940","922473","2204","1003826","0.34"
"2025-09-26T01:54:26.671Z","Included","auto","No","2879","71400","590326","1298","665903","0.25"
"2025-09-26T01:53:06.011Z","Included","auto","No","90463","69167","388691","1780","550101","0.31"
"2025-09-26T01:51:53.189Z","Included","auto","No","2266","67414","463065","1223","533968","0.21"
"2025-09-26T01:51:01.353Z","Included","auto","No","1970","66144","271481","972","340567","0.16"
"2025-09-26T01:50:03.042Z","Included","auto","No","3176","63554","528192","1666","596588","0.23"
"2025-09-26T01:48:08.459Z","Included","auto","No","3281","60973","594856","1938","661048","0.24"
"2025-09-26T01:46:32.489Z","Errored, Not Charged","auto","No","5861","56141","319107","1177","382286","0.16"
"2025-09-26T01:42:14.794Z","Included","auto","No","6104","50746","907461","2754","967065","0.31"
"2025-09-26T01:40:11.586Z","Included","auto","No","10625","41300","1551270","3414","1606609","0.47"
"2025-09-26T01:36:39.914Z","Included","auto","No","36660","25460","508699","5786","576605","0.24"
"2025-09-26T01:32:58.978Z","Included","auto","No","31814","254075","586590","9719","882198","0.56"
"2025-09-26T01:22:30.374Z","Included","auto","No","116265","124721","795617","7157","1043760","0.54"
"2025-09-26T01:21:01.516Z","Included","auto","No","4802","119383","944625","1394","1070204","0.40"
"2025-09-26T01:19:56.274Z","Included","auto","No","836","118451","102321","728","222336","0.18"
"2025-09-26T01:17:34.193Z","Included","auto","No","2021","116515","608555","1223","728314","0.31"
"2025-09-26T01:14:33.776Z","Included","auto","No","31105","101252","2180102","2272","2314731","0.72"
"2025-09-26T01:09:22.910Z","Included","auto","No","125901","61541","3451855","6025","3645322","1.13"
"2025-09-26T01:05:07.152Z","Included","auto","No","59853","45569","690862","1419","797703","0.31"
"2025-09-26T00:58:49.196Z","Included","auto","No","69947","84874","590478","1024","746323","0.35"
"2025-09-26T00:55:05.438Z","Included","auto","No","79988","0","482419","1318","563725","0.23"
"2025-09-26T00:54:48.259Z","Included","auto","No","332","57628","64293","128","122381","0.09"
"2025-09-26T00:54:25.427Z","Included","auto","No","408","57239","63886","202","121735","0.09"
"2025-09-26T00:53:50.156Z","Included","auto","No","465","56775","63422","266","120928","0.09"
"2025-09-26T00:52:39.914Z","Included","auto","No","35416","40878","278727","470","355491","0.17"
"2025-09-26T00:50:01.239Z","Included","auto","No","73969","203777","701674","9085","988505","0.58"
"2025-09-26T00:49:03.277Z","Included","auto","No","7825","97315","213882","214","319236","0.19"
"2025-09-26T00:47:57.234Z","Included","auto","No","12562","82688","679028","1604","775882","0.30"
"2025-09-26T00:43:27.206Z","Included","auto","No","283","82304","93788","183","176558","0.13"
"2025-09-26T00:40:29.457Z","Included","auto","No","276","81974","93513","143","175906","0.13"
"2025-09-26T00:40:19.055Z","Included","auto","No","597","81653","92917","149","175316","0.13"
"2025-09-26T00:39:49.700Z","Included","auto","No","3488","78296","454255","1160","537199","0.22"
"2025-09-26T00:39:35.904Z","Included","auto","No","308","77979","178532","130","256949","0.14"
"2025-09-26T00:38:38.956Z","Included","auto","No","1423","76996","264324","754","343497","0.17"
"2025-09-26T00:38:21.522Z","Included","auto","No","269","76718","87440","101","164528","0.12"
"2025-09-26T00:37:15.864Z","Errored, Not Charged","auto","No","0","76421","0","591","77012","0.10"
"2025-09-26T00:36:48.366Z","Errored, Not Charged","auto","No","0","69337","0","8","69345","0.09"
"2025-09-26T00:36:14.815Z","Included","auto","No","2360","69017","158735","2043","232155","0.14"
"2025-09-26T00:35:55.484Z","Included","auto","No","279","0","78940","160","79379","0.02"
"2025-09-26T00:35:36.508Z","Included","auto","No","197","68338","78744","140","147419","0.11"
"2025-09-26T00:35:13.482Z","Included","auto","No","444","68039","156986","91","225560","0.13"
"2025-09-26T00:34:42.278Z","Included","auto","No","1075","66648","154716","313","222752","0.13"
"2025-09-26T00:34:05.017Z","Included","auto","No","1331","65674","152437","175","219617","0.12"
"2025-09-26T00:33:33.790Z","Included","auto","No","3555","61378","145027","252","210212","0.12"
"2025-09-26T00:31:48.220Z","Included","auto","No","7431","53237","130054","270","190992","0.11"
"2025-09-26T00:31:28.493Z","Included","auto","No","1447","52167","191896","250","245760","0.12"
"2025-09-26T00:30:13.035Z","Included","auto","No","7744","48968","365291","1127","423130","0.17"
"2025-09-26T00:29:00.793Z","Included","auto","No","7248","41300","325486","2049","376083","0.15"
"2025-09-26T00:28:35.050Z","Included","auto","No","656","40930","51820","218","93624","0.07"
"2025-09-26T00:23:41.404Z","Included","auto","No","205","40207","51616","118","92146","0.06"
"2025-09-26T00:22:39.346Z","Included","auto","No","188","39956","51429","95","91668","0.06"
"2025-09-26T00:22:13.924Z","Errored, Not Charged","auto","No","742","39399","101658","213","142012","0.08"
"2025-09-26T00:17:37.937Z","Included","auto","No","360","38876","50233","263","89732","0.06"
"2025-09-26T00:16:29.656Z","Included","auto","No","4480","37778","194722","608","237588","0.11"
"2025-09-26T00:16:00.117Z","Included","auto","No","42057","36375","151907","596","230935","0.14"
"2025-09-26T00:15:21.074Z","Included","auto","No","4428","32810","456528","1740","495506","0.17"
"2025-09-26T00:13:35.373Z","Included","auto","No","33769","0","649848","4922","688539","0.23"
"2025-09-26T00:13:02.482Z","Included","auto","No","0","75720","0","7","75727","0.09"
"2025-09-26T00:12:51.588Z","Included","auto","No","184","75500","78241","98","154023","0.11"
"2025-09-26T00:12:42.355Z","Included","auto","No","179","75275","78063","98","153615","0.11"
"2025-09-26T00:12:27.337Z","Included","auto","No","187","75056","77877","98","153218","0.11"
"2025-09-26T00:12:15.369Z","Included","auto","No","204","74829","77674","103","152810","0.11"
"2025-09-26T00:11:54.431Z","Included","auto","No","261","74584","77414","103","152362","0.11"
"2025-09-26T00:11:31.666Z","Included","auto","No","235","74287","77180","169","151871","0.11"
"2025-09-26T00:10:56.086Z","Included","auto","No","250","74014","76931","133","151328","0.11"
"2025-09-26T00:09:52.344Z","Included","auto","No","103","73722","76829","168","150822","0.11"
"2025-09-26T00:09:02.045Z","Errored, Not Charged","auto","No","1369","109260","75281","1355","187265","0.17"
"2025-09-26T00:04:56.318Z","Included","auto","No","1105","71245","373155","488","445993","0.19"
"2025-09-26T00:04:17.205Z","Included","auto","No","262","70873","73920","250","145305","0.11"
"2025-09-26T00:03:35.354Z","Included","auto","No","1670","70327","219676","251","291924","0.15"
"2025-09-26T00:02:43.295Z","Included","auto","No","1487","68950","435756","551","506744","0.20"
"2025-09-26T00:00:51.415Z","Included","auto","No","5577","63436","403667","506","473186","0.19"
"2025-09-25T23:58:58.121Z","Included","auto","No","4689","90058","1031939","1835","1128521","0.39"
"2025-09-25T23:55:15.344Z","Errored, Not Charged","auto","No","57634","105932","1202090","1089","1366745","0.51"
"2025-09-25T23:53:29.047Z","Included","auto","No","17860","84555","1981520","1593","2085528","0.63"
"2025-09-25T23:51:39.258Z","Included","auto","No","84449","81968","906334","652","1073403","0.44"
"2025-09-25T23:51:10.784Z","Included","auto","No","30854","81655","57758","196","170463","0.16"
"2025-09-25T23:45:20.206Z","Errored, Not Charged","auto","No","77269","121092","3435473","5170","3639004","1.14"
"2025-09-25T23:37:25.167Z","Included","auto","No","159772","98007","11050137","8528","11316444","3.14"
"2025-09-25T23:35:11.172Z","Included","auto","No","15105","89653","2601414","3184","2709356","0.80"
"2025-09-25T23:32:19.794Z","Included","auto","No","14627","76488","3390354","4024","3485493","0.99"
"2025-09-25T23:31:38.281Z","Included","auto","No","289","76236","80332","108","156965","0.12"
"2025-09-25T23:30:44.426Z","Included","auto","No","7977","72997","941627","1246","1023847","0.34"
"2025-09-25T23:25:03.950Z","Included","auto","No","143193","161727","732144","25633","1062697","0.72"
"2025-09-25T23:24:07.716Z","Included","auto","No","6076","77081","158646","399","242202","0.15"
"2025-09-25T23:21:52.498Z","Included","auto","No","6725","70252","1613571","1741","1692289","0.51"
"2025-09-25T23:21:31.738Z","Included","auto","No","938","69811","71418","301","142468","0.11"
"2025-09-25T23:16:19.389Z","Included","auto","No","25102","44370","4289102","4907","4363481","1.19"
"2025-09-25T23:16:09.380Z","Included","auto","No","17183","0","29205","291","46679","0.03"
"2025-09-25T23:07:49.121Z","Included","auto","No","196162","229541","2547340","65453","3038496","1.56"
"2025-09-25T23:03:27.486Z","Included","auto","No","36131","33133","2622212","4608","2696084","0.77"
"2025-09-25T22:49:18.495Z","Errored, Not Charged","auto","No","33854","103121","6725","269","143969","0.17"
"2025-09-25T22:48:41.822Z","Included","auto","No","3577","98001","112210","190","213978","0.16"
"2025-09-25T22:47:36.430Z","Included","auto","No","478","93763","111733","280","206254","0.15"
"2025-09-25T22:46:40.062Z","Included","auto","No","434","93238","111300","1177","206149","0.15"
"2025-09-25T22:46:03.585Z","Included","auto","No","5014","87837","431472","408","524731","0.23"
"2025-09-25T22:45:41.306Z","Included","auto","No","332","87512","105959","141","193944","0.14"
"2025-09-25T22:45:19.339Z","Included","auto","No","839","86856","210814","240","298749","0.16"
"2025-09-25T22:44:50.440Z","Included","auto","No","0","86195","0","7","86202","0.11"
"2025-09-25T22:44:33.010Z","Included","auto","No","201","85872","104635","165","190873","0.13"
"2025-09-25T22:44:12.990Z","Included","auto","No","346","85633","104290","67","190336","0.13"
"2025-09-25T22:43:48.184Z","Included","auto","No","14040","85249","90251","204","189744","0.15"
"2025-09-25T22:34:41.638Z","Errored, Not Charged","auto","No","93666","99426","99848","613","293553","0.27"
"2025-09-25T22:27:13.832Z","Included","auto","No","76620","55544","2622195","17180","2771539","0.92"
"2025-09-25T22:20:13.875Z","Errored, Not Charged","auto","No","53455","106402","2629675","2867","2792399","0.87"
"2025-09-25T22:19:45.308Z","Included","auto","No","233","106102","116769","121","223225","0.16"
"2025-09-25T22:19:05.526Z","Included","auto","No","2717","103241","690251","297","796506","0.31"
"2025-09-25T22:18:49.919Z","Included","auto","No","565","102972","113494","100","217131","0.16"
"2025-09-25T22:18:15.180Z","Included","auto","No","989","102196","225679","683","329547","0.19"
"2025-09-25T22:17:18.890Z","Included","auto","No","1831","101469","110677","504","214481","0.16"
"2025-09-25T22:13:41.079Z","Included","auto","No","18897","82119","473937","3081","578034","0.26"
"2025-09-25T22:09:23.511Z","Included","auto","No","28585","57316","2077364","7452","2170717","0.67"
"2025-09-25T22:04:02.365Z","Errored, Not Charged","auto","No","53741","106735","348041","512","509029","0.29"
"2025-09-25T22:02:07.073Z","Included","auto","No","15973","90282","586054","1413","693722","0.29"
"2025-09-25T21:58:06.527Z","Included","auto","No","17407","72075","892108","1597","983187","0.34"
"2025-09-25T21:50:54.859Z","Included","auto","No","494","71514","77973","378","150359","0.11"
"2025-09-25T21:48:59.381Z","Included","auto","No","71250","70378","84139","105","225872","0.20"
"2025-09-25T21:42:14.469Z","Included","auto","No","145","70191","77122","11","147469","0.11"
"2025-09-25T21:42:05.106Z","Included","auto","No","133","70006","76990","23","147152","0.11"
"2025-09-25T21:41:45.016Z","Errored, Not Charged","auto","No","70084","68633","82592","224","221533","0.20"
"2025-09-25T21:20:12.489Z","Included","auto","No","3465","67678","71540","413","143096","0.11"
"2025-09-25T21:09:09.343Z","Included","auto","No","34736","59264","587524","1188","682712","0.27"
"2025-09-25T20:54:50.033Z","Errored, Not Charged","auto","No","55278","110276","482504","1458","649516","0.34"
"2025-09-25T20:52:55.322Z","Included","auto","No","4323","107069","1169696","1557","1282645","0.44"
"2025-09-25T20:45:06.071Z","Included","auto","No","112408","89998","605629","1429","809464","0.41"
"2025-09-25T20:41:35.307Z","Included","auto","No","17058","72589","1435391","2831","1527869","0.49"
"2025-09-25T20:39:20.814Z","Included","auto","No","18570","55621","721798","4123","800112","0.30"
"2025-09-25T20:38:14.279Z","Included","auto","No","14695","42596","149849","1231","208371","0.12"
"2025-09-25T20:34:32.354Z","Errored, Not Charged","auto","No","39500","107195","806503","1447","954645","0.39"
"2025-09-25T20:31:14.449Z","Included","auto","No","4003","106476","108481","503","219463","0.17"
"2025-09-25T20:28:12.749Z","Included","auto","No","16496","119295","865721","3140","1004652","0.41"
"2025-09-25T20:25:38.083Z","Included","auto","No","33138","84289","332314","610","450351","0.23"
"2025-09-25T20:08:32.202Z","Included","auto","No","106110","162521","1473402","25039","1767072","0.85"
"2025-09-25T20:05:31.936Z","Included","auto","No","3233","79982","273399","1019","357633","0.18"
"2025-09-25T20:04:29.845Z","Included","auto","No","3139","77391","802859","1200","884589","0.31"
"2025-09-25T20:03:01.757Z","Included","auto","No","2589","75379","430166","1023","509157","0.21"
"2025-09-25T20:02:40.114Z","Included","auto","No","527","74839","84517","402","160285","0.12"
"2025-09-25T19:58:49.731Z","Included","auto","No","389","74263","84129","275","159056","0.12"
"2025-09-25T19:58:22.762Z","Included","auto","No","571","73833","83559","305","158268","0.12"
"2025-09-25T19:57:53.651Z","Included","auto","No","471","73199","83089","489","157248","0.12"
"2025-09-25T19:45:36.879Z","Included","auto","No","93211","70730","151884","2003","317828","0.25"
"2025-09-25T19:39:20.193Z","Included","auto","No","90185","177247","1721014","22495","2010941","0.90"
"2025-09-25T19:34:53.477Z","Included","auto","No","20975","76625","1508548","2056","1608204","0.51"
"2025-09-25T19:28:42.423Z","Included","auto","No","79235","61540","1213638","1716","1356129","0.49"
"2025-09-25T18:45:37.464Z","Included","auto","No","63678","146982","2366293","8828","2585781","0.91"
"2025-09-25T09:19:48.075Z","Included","auto","No","0","145842","790272","1405","937519","0.39"
"2025-09-25T09:17:28.242Z","Included","auto","No","0","144104","117248","427","261779","0.21"
"2025-09-25T09:11:38.013Z","Included","auto","No","0","223487","1215744","3590","1442821","0.60"
"2025-09-25T09:09:28.186Z","Included","auto","No","0","93820","173184","287","267291","0.16"
"2025-09-25T09:08:02.591Z","Errored, Not Charged","auto","No","0","9587","822656","2997","835240","0.24"
"2025-09-25T09:06:51.868Z","Included","auto","No","0","87882","65792","781","154455","0.13"
"2025-09-25T09:04:24.132Z","Included","auto","No","0","84310","44416","402","129128","0.12"
"2025-09-25T09:02:34.391Z","Included","auto","No","0","82248","649856","3207","735311","0.28"
"2025-09-25T08:58:33.351Z","Included","auto","No","0","33235","207104","2970","243309","0.11"
"2025-09-25T08:53:03.452Z","Included","auto","No","25930","81801","1498315","2614","1608660","0.52"
"2025-09-25T08:51:43.746Z","Included","auto","No","8727","79891","78207","604","167429","0.13"
"2025-09-25T08:45:06.834Z","Included","auto","No","18447","52382","1481458","2954","1555241","0.48"
"2025-09-25T08:39:06.300Z","Included","auto","No","21125","37345","291077","954","350501","0.15"
"2025-09-25T08:34:07.576Z","Included","auto","No","38631","215110","731594","24387","1009722","0.65"
"2025-09-25T08:24:30.466Z","Included","auto","No","6680","104007","1027669","1887","1140243","0.41"
"2025-09-25T08:22:15.755Z","Included","auto","No","5859","98293","1189128","886","1294166","0.43"
"2025-09-25T08:17:43.760Z","Included","auto","No","20205","78888","923555","2951","1025599","0.37"
"2025-09-25T08:12:58.070Z","Included","auto","No","23526","55093","1225736","3712","1308067","0.43"
"2025-09-25T08:07:52.386Z","Included","auto","No","77629","161327","793067","18923","1050946","0.61"
"2025-09-25T08:02:27.714Z","Included","auto","No","217624","125911","1275083","15283","1633901","0.84"
"2025-09-25T07:49:25.025Z","Included","auto","No","62306","34019","4969958","15085","5081368","1.45"
"2025-09-25T07:47:58.531Z","Included","auto","No","32263","174104","10141","11107","227615","0.33"
"2025-09-25T07:43:51.305Z","Included","auto","No","21336","78906","1361734","3292","1465268","0.49"
"2025-09-25T07:42:04.939Z","Included","auto","No","11441","63985","346500","889","422815","0.19"
"2025-09-25T07:37:20.902Z","Included","auto","No","44717","43749","2567858","7714","2664038","0.80"
"2025-09-25T07:31:02.864Z","Included","auto","No","164133","175148","1091986","13467","1444734","0.78"
"2025-09-25T07:03:27.873Z","Included","auto","No","104410","78665","1963938","6789","2153802","0.76"
"2025-09-25T06:17:54.827Z","Included","auto","No","30025","62093","1148165","3632","1243915","0.42"
"2025-09-25T06:15:05.803Z","Included","auto","No","34576","48796","536939","2543","622854","0.25"
"2025-09-25T06:08:36.903Z","Included","auto","No","49095","194427","1449570","30561","1723653","0.85"
"2025-09-25T06:08:12.406Z","Included","auto","No","578","96418","112226","462","209684","0.15"
"2025-09-25T06:07:19.516Z","Included","auto","No","5369","95816","106858","430","208473","0.16"
"2025-09-25T06:02:04.377Z","Included","auto","No","13678","77736","865345","2647","959406","0.35"
"2025-09-25T06:01:17.337Z","Included","auto","No","1019","77155","92171","400","170745","0.12"
"2025-09-25T05:57:30.101Z","Included","auto","No","15356","64389","575385","3649","658779","0.27"
"2025-09-25T05:54:31.591Z","Included","auto","No","28668","53379","953907","2993","1038947","0.36"
"2025-09-25T05:49:33.085Z","Included","auto","No","55287","189056","670117","26254","940714","0.63"
"2025-09-25T05:45:20.681Z","Included","auto","No","16340","88384","1094142","4122","1202988","0.43"
"2025-09-25T05:40:55.695Z","Included","auto","No","97629","74054","941538","4900","1118121","0.48"
"2025-09-25T05:24:38.987Z","Included","auto","No","29518","60901","603833","3123","697375","0.28"
"2025-09-25T05:18:57.847Z","Included","auto","No","67952","185892","1751140","24903","2029887","0.90"
"2025-09-25T05:12:23.533Z","Included","auto","No","23318","81226","2562132","5414","2672090","0.80"
"2025-09-25T05:09:16.443Z","Included","auto","No","16567","66444","1320424","4405","1407840","0.46"
"2025-09-25T05:08:34.294Z","Included","auto","No","2404","63726","287301","798","354229","0.16"
"2025-09-25T05:07:24.153Z","Included","auto","No","5632","58043","684183","746","748604","0.26"
"2025-09-25T05:06:36.718Z","Included","auto","No","677","57503","64477","330","122987","0.09"
"2025-09-25T05:04:46.948Z","Included","auto","No","11416","45394","722298","1361","780469","0.26"
"2025-09-25T05:04:37.824Z","Included","auto","No","687","44718","52388","428","98221","0.07"
"2025-09-25T05:03:15.197Z","Included","auto","No","8043","36326","89716","610","134695","0.08"
"2025-09-25T04:59:25.672Z","Included","auto","No","39304","201951","619503","17899","878657","0.56"
"2025-09-25T04:58:12.395Z","Included","auto","No","25504","103601","85729","782","215616","0.19"
"2025-09-25T04:52:54.456Z","Included","auto","No","20583","79631","1666514","4795","1771523","0.57"
"2025-09-25T04:50:13.706Z","Included","auto","No","27536","66151","579648","1187","674522","0.27"
"2025-09-25T04:45:11.888Z","Included","auto","No","57295","186908","1545175","14469","1803847","0.78"
"2025-09-25T04:38:52.590Z","Included","auto","No","192647","100718","2345987","14313","2653665","1.04"
"2025-09-25T04:25:54.603Z","Included","auto","No","156881","124878","2147719","22894","2452372","1.03"
"2025-09-25T04:24:01.919Z","Included","auto","No","15278","60370","974867","3703","1054218","0.36"
"2025-09-25T04:20:05.104Z","Included","auto","No","18484","51554","1139265","10691","1219994","0.44"
"2025-09-25T04:14:57.338Z","Included","auto","No","24915","39609","1641586","16732","1722842","0.59"
"2025-09-25T04:14:20.026Z","Included","auto","No","1126","38764","61869","627","102386","0.07"
"2025-09-25T04:11:47.911Z","Included","auto","No","17265","22675","1290164","4960","1335064","0.40"
"2025-09-25T04:10:27.072Z","Included","auto","No","1606","21535","43023","909","67073","0.05"
"2025-09-25T04:05:56.043Z","Included","auto","No","43878","118899","1004422","17880","1185079","0.56"
"2025-09-25T04:03:18.817Z","Included","auto","No","16999","56655","981334","8235","1063223","0.39"
"2025-09-25T03:58:10.120Z","Included","auto","No","13652","48956","1858788","18548","1939944","0.65"
"2025-09-25T03:56:34.155Z","Included","auto","No","8105","45982","449147","6203","509437","0.22"
"2025-09-25T03:55:11.411Z","Included","auto","No","25912","43606","181792","6824","258134","0.17"
"2025-09-25T03:49:26.453Z","Errored, Not Charged","auto","No","54372","78102","919345","14183","1066002","0.48"
"2025-09-25T03:47:17.285Z","Included","auto","No","9627","70870","1131513","4416","1216426","0.41"
"2025-09-25T03:45:11.531Z","Included","auto","No","9924","0","1031105","4552","1045581","0.30"
"2025-09-25T03:42:06.564Z","Included","auto","No","13114","56966","1417106","8799","1495985","0.49"
"2025-09-25T03:40:04.420Z","Included","auto","No","9288","52906","568846","7750","638790","0.27"
"2025-09-25T03:39:21.602Z","Included","auto","No","2304","51548","148003","2406","204261","0.12"
"2025-09-25T03:37:45.151Z","Errored, Not Charged","auto","No","5921","49426","350487","4390","410224","0.18"
"2025-09-25T03:35:23.924Z","Included","auto","No","12552","42379","1015479","7442","1077852","0.37"
"2025-09-25T03:35:07.650Z","Included","auto","No","47463","41551","6742","54","95810","0.11"
"2025-09-25T02:39:31.439Z","Errored, Not Charged","auto","No","48447","89558","1824750","5978","1968733","0.66"
"2025-09-25T02:37:26.400Z","Included","auto","No","105845","88857","6725","512","201939","0.25"
"2025-09-25T02:21:32.998Z","Included","auto","No","201210","81297","962513","3839","1248859","0.62"
"2025-09-25T02:06:28.238Z","Included","auto","No","1214","80604","100518","462","182798","0.13"
"2025-09-25T02:02:58.372Z","Included","auto","No","694","79316","99825","428","180263","0.13"
"2025-09-25T01:59:22.139Z","Included","auto","No","9686","71973","374335","3222","459216","0.21"
"2025-09-25T01:58:03.623Z","Included","auto","No","1390","71236","88754","550","161930","0.12"
"2025-09-25T01:51:02.512Z","Included","auto","No","82042","65403","1035066","1650","1184161","0.45"
"2025-09-25T01:32:03.883Z","Included","auto","No","12687","56182","1055741","4803","1129413","0.38"
"2025-09-25T01:25:55.312Z","Included","auto","No","683","55501","70079","504","126767","0.09"
"2025-09-25T01:22:06.868Z","Included","auto","No","63358","48502","202907","2707","317474","0.21"
"2025-09-25T00:57:20.167Z","Included","auto","No","553","47527","60517","783","109380","0.08"
"2025-09-25T00:54:37.035Z","Included","auto","No","53799","44344","357392","1248","456783","0.22"
"2025-09-25T00:25:02.708Z","Included","auto","No","207938","162464","2699177","24496","3094075","1.28"
"2025-09-25T00:13:22.965Z","Included","auto","No","101786","76707","920070","4459","1103022","0.48"
"2025-09-24T23:43:59.493Z","Included","auto","No","18897","62841","1514733","7840","1604311","0.53"
"2025-09-24T23:42:47.260Z","Included","auto","No","666","62254","75330","348","138598","0.10"
"2025-09-24T23:39:28.584Z","Included","auto","No","68609","56468","221468","2042","348587","0.22"
"2025-09-24T23:33:02.114Z","Included","auto","No","525","56160","68167","126","124978","0.09"
"2025-09-24T23:28:36.391Z","Included","auto","No","13057","42783","1399171","3165","1458176","0.44"
"2025-09-24T23:23:58.177Z","Included","auto","No","48140","0","603620","4383","656143","0.24"
"2025-09-24T22:50:33.211Z","Included","auto","No","326534","217348","6750378","72970","7367230","2.81"
"2025-09-24T22:48:37.370Z","Included","auto","No","89640","861","103482","901","194884","0.14"
"2025-09-24T22:42:53.636Z","Included","auto","No","107657","224399","409710","43582","785348","0.78"
"2025-09-24T22:41:41.349Z","Included","auto","No","5422","68093","189078","451","263044","0.14"
"2025-09-24T22:40:18.454Z","Errored, Not Charged","auto","No","86514","67561","6742","2379","163196","0.21"
"2025-09-24T22:27:04.352Z","Included","auto","No","85577","44262","1448937","9674","1588450","0.58"
"2025-09-24T22:11:39.878Z","Errored, Not Charged","auto","No","56066","78505","1418471","13379","1566421","0.60"
"2025-09-24T22:09:56.920Z","Included","auto","No","13339","76588","100413","899","191239","0.14"
"2025-09-24T22:02:26.330Z","Included","auto","No","105507","68055","1382307","6859","1562728","0.60"
"2025-09-24T21:49:55.969Z","Included","auto","No","91398","58818","732670","7075","889961","0.41"
"2025-09-24T21:38:46.036Z","Included","auto","No","17733","43718","1125079","5955","1192485","0.39"
"2025-09-24T21:36:10.952Z","Included","auto","No","24792","37453","642099","6253","710597","0.28"
"2025-09-24T21:32:37.043Z","Included","auto","No","44542","153581","638701","18881","855705","0.52"
"2025-09-24T21:28:37.752Z","Included","auto","No","111658","76282","1009942","7871","1205753","0.53"
"2025-09-24T21:03:40.885Z","Included","auto","No","114543","51198","2361830","7239","2534810","0.84"
"2025-09-24T21:03:09.798Z","Included","auto","No","1035","50447","75515","582","127579","0.09"
"2025-09-24T20:59:51.448Z","Included","auto","No","1448","49325","74068","418","125259","0.08"
"2025-09-24T20:58:42.297Z","Included","auto","No","67327","47701","6742","583","122353","0.15"
"2025-09-24T20:42:03.112Z","Included","auto","No","19306","33342","287166","1472","341286","0.15"
"2025-09-24T20:34:20.644Z","Included","auto","No","50376","167865","950177","27128","1195546","0.67"
"2025-09-24T20:31:02.381Z","Included","auto","No","14640","81213","1419720","9483","1525056","0.53"
"2025-09-24T20:27:14.329Z","Errored, Not Charged","auto","No","38337","73970","1029640","5950","1147897","0.43"
"2025-09-24T20:18:55.962Z","Included","auto","No","187924","181105","2133834","24698","2527561","1.14"
"2025-09-24T20:13:10.307Z","Included","auto","No","34088","78299","1162768","1701","1276856","0.44"
"2025-09-24T20:04:21.781Z","Errored, Not Charged","auto","No","79710","91730","2194147","6720","2372307","0.80"
"2025-09-24T20:03:15.728Z","Included","auto","No","4051","85311","189821","515","279698","0.16"
"2025-09-24T20:02:54.673Z","Included","auto","No","705","84958","94055","169","179887","0.13"
"2025-09-24T20:02:20.544Z","Included","auto","No","84420","73827","95329","619","254195","0.23"
"2025-09-24T19:58:46.986Z","Included","auto","No","35108","70834","2336606","5239","2447787","0.75"
"2025-09-24T19:48:57.099Z","Included","auto","No","127651","0","1268961","10006","1406618","0.54"
"2025-09-24T19:43:02.365Z","Errored, Not Charged","auto","No","73457","80002","1001107","8406","1162972","0.49"
"2025-09-24T19:38:37.287Z","Included","auto","No","15899","69813","3771409","7634","3864755","1.10"
"2025-09-24T19:35:48.996Z","Included","auto","No","19435","50573","1630833","5404","1706245","0.53"
"2025-09-24T19:30:42.415Z","Included","auto","No","25946","41457","715382","16565","799350","0.36"
"2025-09-24T19:24:04.509Z","Errored, Not Charged","auto","No","67505","87238","1841731","10009","2006483","0.71"
"2025-09-24T19:20:51.314Z","Included","auto","No","13453","84517","667852","8756","774578","0.34"
"2025-09-24T19:13:16.692Z","Errored, Not Charged","auto","No","120308","96816","1552575","10033","1779732","0.72"
"2025-09-24T19:08:49.843Z","Included","auto","No","150174","69846","1707141","4625","1931786","0.73"
"2025-09-24T19:02:22.728Z","Included","auto","No","61398","224175","938171","47503","1271247","0.88"
"2025-09-24T18:55:02.815Z","Included","auto","No","103864","63596","645904","11372","824736","0.44"
"2025-09-24T08:57:46.226Z","Included","auto","No","18869","51185","977039","10245","1057338","0.39"
"2025-09-24T08:53:46.590Z","Included","auto","No","2932","47504","176148","505","227089","0.11"
"2025-09-24T08:52:15.476Z","Included","auto","No","9213","42649","313821","3983","369666","0.17"
"2025-09-24T08:51:19.507Z","Included","auto","No","42500","34975","220334","3575","301384","0.17"
"2025-09-24T08:49:01.330Z","Included","auto","No","0","28973","78848","1684","109505","0.07"
"2025-09-24T08:48:10.265Z","Errored, Not Charged","auto","No","0","2155","169088","931","172174","0.05"
"2025-09-24T08:44:01.641Z","Included","auto","No","0","174588","163328","1919","339835","0.27"
"2025-09-24T08:40:56.437Z","Included","auto","No","0","172329","480000","1000","653329","0.34"
"2025-09-24T08:35:28.455Z","Included","auto","No","0","165367","154240","1441","321048","0.25"
"2025-09-24T08:29:13.726Z","Included","auto","No","0","156621","684288","4087","844996","0.39"
"2025-09-24T08:19:35.413Z","Errored, Not Charged","auto","No","0","136505","1121024","1642","1259171","0.46"
"2025-09-24T08:11:23.698Z","Included","auto","No","0","125742","571904","1681","699327","0.31"
"2025-09-24T08:09:02.722Z","Included","auto","No","0","117495","295040","779","413314","0.23"
"2025-09-24T08:07:34.420Z","Included","auto","No","0","102275","97664","514","200453","0.16"
"2025-09-24T08:04:09.080Z","Included","auto","No","0","165270","1025024","5746","1196040","0.50"
"2025-09-24T07:58:52.316Z","Included","auto","No","0","60875","44928","2771","108574","0.10"
"2025-09-24T07:55:19.643Z","Included","auto","No","0","276566","1222912","1950","1501428","0.66"
"2025-09-24T07:53:43.910Z","Included","auto","No","0","270124","726784","890","997798","0.52"
"2025-09-24T07:53:15.084Z","Included","auto","No","0","269357","241280","426","511063","0.40"
"2025-09-24T07:52:47.832Z","Included","auto","No","0","352460","156672","213","509345","0.48"
"2025-09-24T07:51:54.294Z","Included","auto","No","0","157426","156416","248","314090","0.24"
"2025-09-24T07:51:05.324Z","Included","auto","No","0","177385","135808","489","313682","0.26"
"2025-09-24T07:45:08.099Z","Included","auto","No","0","134374","394880","2228","531482","0.28"
"2025-09-24T07:42:51.999Z","Included","auto","No","0","129934","380800","1985","512719","0.27"
"2025-09-24T07:41:02.786Z","Included","auto","No","0","125495","370048","505","496048","0.25"
"2025-09-24T07:31:07.057Z","Included","auto","No","0","123370","358784","1544","483698","0.25"
"2025-09-24T07:29:31.096Z","Included","auto","No","0","161317","189312","1156","351785","0.26"
"2025-09-24T07:26:28.084Z","Included","auto","No","0","428117","153600","21450","603167","0.70"
"2025-09-24T07:23:04.073Z","Included","auto","No","0","242221","927616","1891","1171728","0.55"
"2025-09-24T07:22:04.362Z","Included","auto","No","0","238122","230528","339","468989","0.36"
"2025-09-24T07:20:55.417Z","Included","auto","No","0","237736","230144","121","468001","0.36"
"2025-09-24T07:20:03.199Z","Included","auto","No","0","237270","229760","242","467272","0.36"
"2025-09-24T07:18:23.557Z","Included","auto","No","0","237288","228864","168","466320","0.35"
"2025-09-24T07:16:19.933Z","Included","auto","No","0","236978","675840","1030","913848","0.47"
"2025-09-24T07:12:57.164Z","Included","auto","No","0","182","6528","52","6762","0.002"
"2025-09-24T07:12:34.463Z","Included","auto","No","0","6701","0","60","6761","0.01"
"2025-09-24T07:09:29.654Z","Included","auto","No","0","30743","1264686","1345","1296774","0.36"
"2025-09-24T07:07:12.427Z","Included","auto","No","0","217764","627456","1064","846284","0.44"
"2025-09-24T07:04:57.824Z","Included","auto","No","0","213613","1025920","971","1240504","0.53"
"2025-09-24T07:03:04.174Z","Included","auto","No","0","7552","806616","1533","815701","0.22"
"2025-09-24T07:01:55.896Z","Included","auto","No","0","206998","596352","909","804259","0.41"
"2025-09-24T07:00:36.188Z","Included","auto","No","0","216162","576512","950","793624","0.42"
"2025-09-24T06:56:55.748Z","Included","auto","No","0","201386","1136000","1021","1338407","0.54"
"2025-09-24T06:56:15.257Z","Errored, Not Charged","auto","No","0","1022","0","3","1025","0.001"
"2025-09-24T06:55:54.669Z","Included","auto","No","0","1555","12544","264","14363","0.01"
"2025-09-24T06:54:36.977Z","Errored, Not Charged","auto","No","0","194010","556416","1292","751718","0.39"
"2025-09-24T06:53:20.489Z","Included","auto","No","0","193008","367744","1107","561859","0.34"
"2025-09-24T06:52:11.754Z","Included","auto","No","0","374942","0","1288","376230","0.48"
"2025-09-24T06:50:51.566Z","Included","auto","No","0","190821","546688","426","737935","0.38"
"2025-09-24T06:48:54.935Z","Included","auto","No","0","188419","538368","465","727252","0.37"
"2025-09-24T06:48:06.137Z","Included","auto","No","0","185424","178816","500","364740","0.28"
"2025-09-24T06:44:59.356Z","Errored, Not Charged","auto","No","0","186136","709632","2278","898046","0.42"
"2025-09-24T06:44:19.495Z","Included","auto","No","0","226364","133248","510","360122","0.32"
"2025-09-24T06:43:04.030Z","Included","auto","No","0","259575","84992","1243","345810","0.35"
"2025-09-24T06:35:11.700Z","Included","auto","No","0","66653","399360","2447","468460","0.20"
"2025-09-24T06:34:31.032Z","Included","auto","No","0","55495","73856","690","130041","0.09"
"2025-09-24T06:33:48.349Z","Included","auto","No","0","54913","73216","687","128816","0.09"
"2025-09-24T06:32:55.274Z","Included","auto","No","0","53903","72832","1041","127776","0.09"
"2025-09-24T06:31:44.726Z","Errored, Not Charged","auto","No","0","52950","0","7","52957","0.07"
"2025-09-24T06:30:41.688Z","Included","auto","No","10330","48780","256592","390","316092","0.14"
"2025-09-24T06:27:22.250Z","Included","auto","No","23459","34590","2091097","4612","2153758","0.62"
"2025-09-24T06:22:32.014Z","Included","auto","No","66479","184397","866295","26142","1143313","0.69"
"2025-09-24T06:20:03.247Z","Included","auto","No","0","95143","331904","2142","429189","0.21"
"2025-09-24T06:17:51.787Z","Included","auto","No","0","89031","707072","2057","798160","0.30"
"2025-09-24T06:16:03.555Z","Included","auto","No","0","163515","583296","2042","748853","0.36"
"2025-09-24T06:09:53.151Z","Included","auto","No","203083","218932","1059232","25188","1506435","0.94"
"2025-09-24T06:03:53.388Z","Included","auto","No","120985","43646","3121903","8228","3294762","1.04"
"2025-09-24T05:54:21.557Z","Included","auto","No","138569","266941","1679584","18794","2103888","1.04"
"2025-09-24T05:42:25.406Z","Included","auto","No","72454","30023","1633171","21452","1757100","0.67"
"2025-09-24T05:12:05.178Z","Errored, Not Charged","auto","No","178168","300169","2328988","71550","2878875","1.61"
"2025-09-24T05:10:22.769Z","Included","auto","No","2963","82097","384244","555","469859","0.21"
"2025-09-24T05:09:41.623Z","Included","auto","No","6642","78163","553840","560","639205","0.25"
"2025-09-24T05:07:05.082Z","Included","auto","No","134894","55394","2025821","5246","2221355","0.78"
"2025-09-24T05:02:11.118Z","Included","auto","No","54908","105606","1679979","12530","1853023","0.70"
"2025-09-24T05:00:50.088Z","Included","auto","No","9360","77189","1329439","1431","1417419","0.45"
"2025-09-24T04:59:11.017Z","Errored, Not Charged","auto","No","109301","113702","1234689","6570","1464262","0.63"
"2025-09-24T04:50:36.526Z","Included","auto","No","169309","90893","3474760","32782","3767744","1.39"
"2025-09-24T04:48:13.239Z","Included","auto","No","13473","22589","289524","2535","328121","0.13"
"2025-09-24T04:46:22.577Z","Included","auto","No","23823","105958","455843","2860","588484","0.29"
"2025-09-24T04:43:10.068Z","Included","auto","No","16212","94574","1381619","2312","1494717","0.50"
"2025-09-24T04:41:45.794Z","Included","auto","No","11708","0","582125","883","594716","0.17"
"2025-09-24T04:39:09.088Z","Included","auto","No","21202","82669","1093879","1342","1199092","0.41"
"2025-09-24T04:35:47.945Z","Included","auto","No","24081","68722","1559220","2411","1654434","0.52"
"2025-09-24T04:32:59.506Z","Included","auto","No","43704","58390","943222","1902","1047218","0.37"
"2025-09-24T04:28:52.076Z","Included","auto","No","11227","58805","188560","721","259313","0.14"
"2025-09-24T04:26:50.730Z","Included","auto","No","11001","46874","505122","1418","564415","0.21"
"2025-09-24T04:26:21.422Z","Included","auto","No","46179","26815","41806","561","115361","0.11"
"2025-09-24T04:23:38.860Z","Included","auto","No","23848","0","149874","825","174547","0.07"
"2025-09-24T04:21:18.789Z","Included","auto","No","4171","94818","562983","448","662420","0.27"
"2025-09-24T04:19:33.408Z","Errored, Not Charged","auto","No","6820","0","534639","3270","544729","0.16"
"2025-09-24T04:17:34.968Z","Included","auto","No","4252","84462","201317","345","290376","0.16"
"2025-09-24T04:12:34.638Z","Included","auto","No","36653","58455","757343","10376","862827","0.37"
"2025-09-24T04:08:55.325Z","Included","auto","No","57925","44052","361211","1364","464552","0.23"
"2025-09-24T02:43:25.516Z","Included","auto","No","437","43620","53574","90","97721","0.07"
"2025-09-24T02:42:28.320Z","Included","auto","No","2591","42526","315909","568","361594","0.14"
"2025-09-24T02:41:23.174Z","Errored, Not Charged","auto","No","44130","38694","552043","877","635744","0.25"
"2025-09-24T02:40:28.277Z","Included","auto","No","37173","0","196024","1859","235056","0.11"
"2025-09-24T02:37:30.932Z","Included","auto","No","2153","63869","345600","341","411963","0.17"
"2025-09-24T02:37:06.840Z","Included","auto","No","765","63371","67786","307","132229","0.10"
"2025-09-24T02:34:34.601Z","Included","auto","No","6002","62101","264091","408","332602","0.15"
"2025-09-24T02:30:14.242Z","Included","auto","No","55074","48275","570259","5021","678629","0.30"
"2025-09-24T02:19:03.048Z","Included","auto","No","27124","18579","635925","2234","683862","0.23"
"2025-09-24T02:11:57.964Z","Included","auto","No","16813","200050","31742","9550","258155","0.34"
"2025-09-24T02:08:27.605Z","Included","auto","No","4066","97327","229625","578","331596","0.19"
"2025-09-24T02:07:16.023Z","Included","auto","No","765","96653","113734","499","211651","0.15"
"2025-09-24T02:02:01.820Z","Included","auto","No","3917","92572","220284","789","317562","0.18"
"2025-09-24T01:53:49.806Z","Included","auto","No","5195","87422","210014","802","303433","0.17"
"2025-09-24T01:50:43.662Z","Included","auto","No","3936","83369","202114","724","290143","0.16"
"2025-09-24T01:47:45.017Z","Included","auto","No","7014","79597","191373","709","278693","0.16"
"2025-09-24T01:44:28.601Z","Included","auto","No","3820","75452","186838","668","266778","0.15"
"2025-09-24T01:30:21.193Z","Included","auto","No","11574","70143","1417609","3872","1503198","0.48"
"2025-09-24T01:30:09.579Z","Included","auto","No","5218","65741","76394","337","147690","0.11"
"2025-09-24T01:23:35.415Z","Included","auto","No","5079","60421","152269","682","218451","0.12"
"2025-09-24T01:18:08.604Z","Included","auto","No","69156","55020","6725","339","131240","0.16"
"2025-09-24T01:13:05.253Z","Included","auto","No","28451","35425","1364227","8812","1436915","0.47"
"2025-09-24T01:11:49.191Z","Included","auto","No","17885","31045","414060","1666","464656","0.17"
"2025-09-24T01:06:09.272Z","Included","auto","No","33575","193341","940289","13014","1180219","0.60"
"2025-09-24T01:02:50.948Z","Included","auto","No","6907","92766","791348","1190","892211","0.33"
"2025-09-24T00:58:14.428Z","Included","auto","No","738","91768","219235","469","312210","0.17"
"2025-09-24T00:56:24.559Z","Included","auto","No","5469","91209","103905","342","200925","0.15"
"2025-09-24T00:52:10.199Z","Included","auto","No","12101","74798","1172660","2861","1262420","0.42"
"2025-09-24T00:46:03.945Z","Included","auto","No","17264","73843","74553","618","166278","0.14"
"2025-09-24T00:36:52.010Z","Included","auto","No","39062","41409","3069659","12579","3162709","0.94"
"2025-09-24T00:35:57.275Z","Included","auto","No","5235","40827","46666","375","93103","0.07"
"2025-09-24T00:32:41.900Z","Errored, Not Charged","auto","No","51996","92214","589240","2797","736247","0.34"
"2025-09-24T00:29:16.553Z","Included","auto","No","6970","87142","884323","3545","981980","0.36"
"2025-09-24T00:28:54.426Z","Included","auto","No","13681","86686","93443","275","194085","0.15"
"2025-09-24T00:26:15.578Z","Included","auto","No","13952","78181","1062170","7307","1161610","0.42"
"2025-09-24T00:10:46.806Z","Included","auto","No","130344","61042","3151440","12046","3354872","1.10"
"2025-09-24T00:04:32.463Z","Errored, Not Charged","auto","No","55813","85106","1932253","5954","2079126","0.69"
"2025-09-24T00:03:24.914Z","Included","auto","No","1830","84317","114832","557","201536","0.14"
"2025-09-24T00:01:40.259Z","Included","auto","No","1941","82362","112892","1384","198579","0.14"
"2025-09-23T23:57:03.842Z","Included","auto","No","5870","80188","326082","5629","417769","0.22"
"2025-09-23T23:52:45.105Z","Included","auto","No","22131","77758","395953","3322","499164","0.24"
"2025-09-23T23:34:33.280Z","Included","auto","No","119199","133404","6278175","38503","6569281","2.12"
"2025-09-23T23:28:12.817Z","Included","auto","No","31409","54057","4335922","12200","4433588","1.26"
"2025-09-23T23:27:01.620Z","Included","auto","No","596","53415","58033","399","112443","0.08"
"2025-09-23T23:26:09.677Z","Included","auto","No","597","52772","57437","458","111264","0.08"
"2025-09-23T23:25:05.087Z","Included","auto","No","554","52125","56884","415","109978","0.08"
"2025-09-23T23:24:44.063Z","Included","auto","No","583","51514","56302","424","108823","0.08"
"2025-09-23T23:24:18.312Z","Included","auto","No","600","50872","55703","461","107636","0.08"
"2025-09-23T23:23:06.739Z","Included","auto","No","553","50219","55151","417","106340","0.08"
"2025-09-23T23:22:32.377Z","Included","auto","No","533","49614","54619","410","105176","0.08"
"2025-09-23T23:21:34.511Z","Included","auto","No","560","49036","54060","375","104031","0.08"
"2025-09-23T23:20:45.162Z","Included","auto","No","579","48431","53482","388","102880","0.08"
"2025-09-23T23:19:38.921Z","Included","auto","No","46741","47804","6742","395","101682","0.12"
"2025-09-23T22:56:16.444Z","Included","auto","No","47304","139421","289684","21369","497778","0.43"
"2025-09-23T22:55:07.372Z","Included","auto","No","3637","67692","996718","1423","1069470","0.35"
"2025-09-23T22:48:15.889Z","Included","auto","No","6898","61672","2015444","1849","2085863","0.60"
"2025-09-23T22:47:42.472Z","Included","auto","No","685","60566","102098","928","164277","0.11"
"2025-09-23T22:42:55.790Z","Included","auto","No","2180","59808","99919","557","162464","0.11"
"2025-09-23T22:41:23.269Z","Included","auto","No","869","57471","99051","670","158061","0.10"
"2025-09-23T22:38:57.397Z","Included","auto","No","17602","42720","1101210","4421","1165953","0.38"
"2025-09-23T22:37:38.715Z","Included","auto","No","5765","41645","388918","5451","441779","0.19"
"2025-09-23T22:36:48.465Z","Included","auto","No","711","40940","74991","464","117106","0.07"
"2025-09-23T22:35:23.492Z","Included","auto","No","1434","40147","73558","572","115711","0.07"
"2025-09-23T22:33:32.921Z","Included","auto","No","1613","38697","71946","1300","113556","0.08"
"2025-09-23T22:33:09.196Z","Included","auto","No","1588","37032","70359","1486","110465","0.07"
"2025-09-23T22:32:01.077Z","Included","auto","No","993","35354","69367","1410","107124","0.07"
"2025-09-23T22:28:41.993Z","Included","auto","No","10106","33987","315203","9593","368889","0.19"
"2025-09-23T22:23:07.388Z","Included","auto","No","64827","134728","567306","28795","795656","0.56"
"2025-09-23T22:20:31.809Z","Included","auto","No","20189","58960","535635","8857","623641","0.29"
"2025-09-23T22:12:34.792Z","Included","auto","No","12442","52242","614057","8200","686941","0.28"
"2025-09-23T22:00:41.942Z","Included","auto","No","80053","49218","259630","7501","396402","0.27"
"2025-09-23T21:57:21.018Z","Included","auto","No","53221","34928","1529108","7949","1625206","0.54"
"2025-09-23T21:56:19.288Z","Included","auto","No","42251","96327","456281","3455","598314","0.31"
"2025-09-23T21:55:25.207Z","Included","auto","No","77027","0","33349","463","110839","0.11"
"2025-09-23T21:45:12.283Z","Included","auto","No","235722","175705","2547427","43455","3002309","1.41"
"2025-09-23T21:35:22.662Z","Included","auto","No","54217","118120","361353","35395","569085","0.52"
"2025-09-23T21:32:59.185Z","Included","auto","No","1600","57703","112341","1281","172925","0.11"
"2025-09-23T21:31:22.060Z","Included","auto","No","1533","56075","110809","1457","169874","0.11"
"2025-09-23T21:23:25.185Z","Included","auto","No","1079","54392","109731","1128","166330","0.10"
"2025-09-23T21:18:24.850Z","Included","auto","No","26386","40353","2368379","16189","2451307","0.77"
"2025-09-23T21:17:32.782Z","Included","auto","No","1631","39095","81739","1049","123514","0.08"
"2025-09-23T21:12:52.713Z","Included","auto","No","8125","33995","379682","5292","427094","0.18"
"2025-09-23T21:02:46.656Z","Included","auto","No","86192","22426","1751497","6315","1866430","0.61"
"2025-09-23T20:57:27.921Z","Included","auto","No","48797","87518","734826","25487","896628","0.51"
"2025-09-23T20:53:30.041Z","Included","auto","No","16577","40817","843660","12807","913861","0.36"
"2025-09-23T20:49:51.243Z","Included","auto","No","48840","39464","409789","13193","511286","0.29"
"2025-09-23T20:30:20.589Z","Included","auto","No","72864","126519","2310946","29101","2539430","1.00"
"2025-09-23T20:24:24.647Z","Included","auto","No","33844","55050","2080589","19139","2188622","0.75"
"2025-09-23T20:17:31.287Z","Included","auto","No","9129","49024","567927","2700","628780","0.23"
"2025-09-23T20:16:12.895Z","Included","auto","No","12091","41492","591102","2088","646773","0.23"
"2025-09-23T20:11:37.097Z","Included","auto","No","43123","14483","1604560","6812","1668978","0.51"
"2025-09-23T20:06:30.585Z","Errored, Not Charged","auto","No","142378","75919","803339","11347","1032983","0.54"
"2025-09-23T20:02:22.243Z","Included","auto","No","10913","69640","533625","8423","622601","0.28"
"2025-09-23T19:59:26.353Z","Included","auto","No","6722","67055","395463","4469","473709","0.22"
"2025-09-23T19:57:19.551Z","Included","auto","No","8904","63245","646705","6706","725560","0.29"
"2025-09-23T19:56:00.356Z","Included","auto","No","2099","62646","171534","1908","238187","0.14"
"2025-09-23T19:54:16.983Z","Included","auto","No","1985","62006","167578","1815","233384","0.13"
"2025-09-23T19:48:09.124Z","Included","auto","No","557","61376","82937","194","145064","0.10"
"2025-09-23T19:45:43.136Z","Included","auto","No","5135","59044","318473","3265","385917","0.18"
"2025-09-23T19:44:19.387Z","Included","auto","No","1834","58287","152654","1658","214433","0.12"
"2025-09-23T19:42:05.756Z","Included","auto","No","8637","49772","281499","1746","341654","0.15"
"2025-09-23T19:40:51.320Z","Included","auto","No","889","48728","133320","467","183404","0.10"
"2025-09-23T19:30:04.137Z","Included","auto","No","3078","47065","321274","2386","373803","0.16"
"2025-09-23T19:29:35.973Z","Included","auto","No","1012","46688","187946","604","236250","0.11"
"2025-09-23T19:28:07.914Z","Included","auto","No","55483","41472","470863","4146","571964","0.26"
"2025-09-23T19:07:58.044Z","Included","auto","No","12216","29603","420550","2634","465003","0.17"
"2025-09-23T19:06:06.215Z","Included","auto","No","34245","25723","473937","1762","535667","0.20"
"2025-09-23T17:31:11.387Z","Included","auto","No","29053","382302","110004","9631","530990","0.60"
"2025-09-23T08:56:47.146Z","Included","auto","No","0","185734","371456","1500","558690","0.33"
"2025-09-23T08:52:19.179Z","Included","auto","No","0","363586","376576","1033","741195","0.55"
"2025-09-23T08:50:12.135Z","Included","auto","No","0","187529","358016","2114","547659","0.34"
"2025-09-23T08:47:36.598Z","Included","auto","No","0","518330","538624","559","1057513","0.79"
"2025-09-23T08:41:24.365Z","Included","auto","No","0","7106","503337","375","510818","0.14"
"2025-09-23T08:40:40.134Z","Included","auto","No","0","166999","168192","956","336147","0.26"
"2025-09-23T08:35:18.014Z","Included","auto","No","0","329175","1628928","4202","1962305","0.84"
"2025-09-23T08:29:30.791Z","Included","auto","No","0","17823","600492","3576","621891","0.19"
"2025-09-23T08:27:20.394Z","Included","auto","No","0","153946","297472","1361","452779","0.27"
"2025-09-23T08:22:25.631Z","Included","auto","No","0","144293","548992","2420","695705","0.33"
"2025-09-23T08:16:50.288Z","Included","auto","No","0","127830","1388800","4288","1520918","0.53"
"2025-09-23T08:16:07.737Z","Included","auto","No","0","134795","71808","848","207451","0.19"
"2025-09-23T08:15:09.370Z","Included","auto","No","0","252976","6400","137","259513","0.32"
"2025-09-23T07:03:28.229Z","Included","auto","No","0","245422","601856","1784","849062","0.47"
"2025-09-23T07:01:02.234Z","Included","auto","No","0","108948","577536","1530","688014","0.29"
"2025-09-23T06:56:45.089Z","Included","auto","No","0","55091","890240","5267","950598","0.32"
"2025-09-23T06:54:01.334Z","Included","auto","No","0","103740","1952256","1808","2057804","0.63"
"2025-09-23T06:50:58.220Z","Included","auto","No","0","96447","532352","780","629579","0.26"
"2025-09-23T06:42:23.345Z","Included","auto","No","0","11035","214542","133","225710","0.07"
"2025-09-23T06:37:01.843Z","Included","auto","No","0","94966","2379136","3408","2477510","0.73"
"2025-09-23T06:36:17.762Z","Included","auto","No","0","82531","120704","529","203764","0.14"
"2025-09-23T06:33:01.441Z","Included","auto","No","0","82153","928000","2373","1012526","0.35"
"2025-09-23T06:32:05.333Z","Included","auto","No","0","73846","112384","243","186473","0.12"
"2025-09-23T06:29:31.869Z","Included","auto","No","0","73227","220032","913","294172","0.15"
"2025-09-23T06:27:22.384Z","Included","auto","No","0","167937","752640","2104","922681","0.41"
"2025-09-23T06:21:00.827Z","Included","auto","No","33555","50630","1465452","9875","1559512","0.53"
"2025-09-23T06:16:01.078Z","Errored, Not Charged","auto","No","77209","68125","2315385","6781","2467500","0.80"
"2025-09-23T06:11:35.231Z","Included","auto","No","36521","57652","1122629","16573","1233375","0.50"
"2025-09-23T05:57:16.036Z","Included","auto","No","86708","113751","1852806","49474","2102739","1.01"
"2025-09-23T05:53:30.579Z","Included","auto","No","33728","44290","4337312","6813","4422143","1.22"
"2025-09-23T05:46:57.451Z","Included","auto","No","113140","157130","1607916","22216","1900402","0.87"
"2025-09-23T05:40:22.994Z","Included","auto","No","99827","156913","5865934","18149","6140823","1.90"
"2025-09-23T05:39:27.929Z","Included","auto","No","51784","48080","726910","959","827733","0.31"
"2025-09-23T05:39:16.712Z","Included","auto","No","27277","47524","34465","366","109632","0.10"
"2025-09-23T05:26:50.584Z","Included","auto","No","163153","105886","2336897","13590","2619526","1.00"
"2025-09-22T22:43:28.513Z","Included","auto","No","51590","0","1138843","729","1191162","0.35"
"2025-09-22T22:42:52.478Z","Included","auto","No","7384","0","430924","2041","440349","0.13"
"2025-09-22T22:41:45.206Z","Included","auto","No","18760","0","651038","4119","673917","0.21"
"2025-09-22T22:41:00.575Z","Included","auto","No","283","0","61184","148","61615","0.02"
"2025-09-22T22:39:46.575Z","Included","auto","No","3856","0","81110","809","85775","0.03"
"2025-09-22T22:39:25.244Z","Included","auto","No","1951","0","75570","751","78272","0.03"
"2025-09-22T22:37:54.285Z","Included","auto","No","5596","0","172539","1834","179969","0.06"
"2025-09-22T22:34:26.606Z","Included","auto","No","10294","0","247153","2457","259904","0.09"
"2025-09-22T22:33:49.778Z","Errored, Not Charged","auto","No","0","0","0","0","0","0.00"
"2025-09-22T22:31:54.595Z","Included","auto","No","8025","0","679548","6401","693974","0.22"
"2025-09-22T22:31:22.036Z","Errored, Not Charged","auto","No","0","0","0","0","0","0.00"
"2025-09-22T22:29:29.583Z","Included","auto","No","10098","0","1536772","4995","1551865","0.43"
"2025-09-22T22:28:50.138Z","Included","auto","No","2893","0","288630","2572","294095","0.09"
"2025-09-22T22:17:29.716Z","Included","auto","No","12150","0","1896259","4072","1912481","0.51"
"2025-09-22T22:17:06.423Z","Errored, Not Charged","auto","No","142","0","82681","63","82886","0.02"
"2025-09-22T22:16:24.850Z","Included","auto","No","6911","0","562237","1100","570248","0.16"
"2025-09-22T22:09:55.112Z","Errored, Not Charged","auto","No","3654","0","368100","2113","373867","0.11"
"2025-09-22T21:57:58.598Z","Included","auto","No","69232","0","560160","1644","631036","0.24"
"2025-09-22T21:55:20.642Z","Included","auto","No","20710","0","1050694","9130","1080534","0.34"
"2025-09-22T21:53:25.441Z","Included","auto","No","36811","0","7060","462","44333","0.05"
"2025-09-22T21:35:24.547Z","Included","auto","No","23117","0","734336","4773","762226","0.24"
"2025-09-22T21:34:02.679Z","Included","auto","No","2742","0","209004","2193","213939","0.07"
"2025-09-22T21:33:12.102Z","Included","auto","No","14954","0","386343","793","402090","0.12"
"2025-09-22T21:32:43.087Z","Errored, Not Charged","auto","No","2517","0","261803","187","264507","0.07"
"2025-09-22T21:16:48.370Z","Errored, Not Charged","auto","No","271234","0","1880334","5554","2157122","0.84"
"2025-09-22T21:14:18.287Z","Included","auto","No","41083","0","1792311","2291","1835685","0.51"
"2025-09-22T21:13:17.950Z","Included","auto","No","25203","0","725356","1914","752473","0.22"
"2025-09-22T20:57:34.013Z","Errored, Not Charged","auto","No","334563","134261","4256734","78545","4804103","2.12"
"2025-09-22T20:40:47.332Z","Included","auto","No","107671","0","4756358","12477","4876506","1.40"
"2025-09-22T20:36:06.507Z","Included","auto","No","37154","0","1248346","14018","1299518","0.44"
"2025-09-22T20:33:00.163Z","Included","auto","No","40577","0","1601594","2784","1644955","0.47"
"2025-09-22T19:55:54.720Z","Included","auto","No","555027","218715","3014516","61095","3849353","2.09"
"2025-09-22T19:52:44.847Z","Included","auto","No","10910","0","733423","4324","748657","0.22"
"2025-09-22T19:46:30.902Z","Included","auto","No","66996","0","1527500","4486","1598982","0.49"
"2025-09-22T19:41:59.291Z","Included","auto","No","42369","89683","798619","7467","938138","0.41"
"2025-09-22T19:35:06.902Z","Included","auto","No","21924","0","1363019","7747","1392690","0.41"
"2025-09-22T19:29:38.989Z","Included","auto","No","39063","0","2482917","4384","2526364","0.70"
"2025-09-22T19:24:43.588Z","Included","auto","No","10728","0","438223","2125","451076","0.14"
"2025-09-22T19:23:42.683Z","Included","auto","No","3507","0","509451","1065","514023","0.14"
"2025-09-22T19:22:42.756Z","Errored, Not Charged","auto","No","33672","0","190366","779","224817","0.09"
"2025-09-22T19:18:55.099Z","Included","auto","No","30501","76249","1418275","13537","1538562","0.57"
"2025-09-22T19:18:35.166Z","Included","auto","No","1829","0","320962","299","323090","0.08"
"2025-09-22T19:18:08.480Z","Included","auto","No","357","0","106156","152","106665","0.03"
"2025-09-22T19:16:39.903Z","Included","auto","No","166","0","105991","103","106260","0.03"
"2025-09-22T19:15:57.419Z","Errored, Not Charged","auto","No","4134","0","207168","111","211413","0.06"
"2025-09-22T19:14:10.312Z","Included","auto","No","0","213011","124160","1693","338864","0.31"
"2025-09-22T19:13:14.239Z","Errored, Not Charged","auto","No","96655","0","724740","488","821883","0.30"
"2025-09-22T11:29:24.195Z","Included","auto","No","57518","0","1099749","5735","1163002","0.38"
"2025-09-22T11:15:52.798Z","Included","auto","No","213727","74602","8575537","33483","8897349","2.71"
"2025-09-22T11:10:01.074Z","Included","auto","No","86097","0","2857358","4135","2947590","0.85"
"2025-09-22T11:01:13.721Z","Included","auto","No","72305","0","1051996","8624","1132925","0.41"
"2025-09-22T10:59:36.824Z","Included","auto","No","8061","0","553244","1103","562408","0.16"
"2025-09-22T10:46:52.501Z","Included","auto","No","100175","0","3869368","7032","3976575","1.13"
"2025-09-22T10:44:40.683Z","Included","auto","No","118373","0","543339","3717","665429","0.31"
"2025-09-22T10:36:08.341Z","Included","auto","No","79717","106121","2461054","14360","2661252","0.93"
"2025-09-22T10:34:01.224Z","Included","auto","No","8479","0","1578554","1640","1588673","0.42"
"2025-09-22T10:33:27.832Z","Included","auto","No","932","0","320596","298","321826","0.08"
"2025-09-22T10:31:54.440Z","Included","auto","No","5715","0","723578","1996","731289","0.20"
"2025-09-22T10:30:01.376Z","Included","auto","No","8998","0","1546736","3791","1559525","0.42"
"2025-09-22T10:29:26.056Z","Included","auto","No","1592","0","454770","389","456751","0.12"
"2025-09-22T10:28:29.880Z","Included","auto","No","4487","0","259532","421","264440","0.07"
"2025-09-22T10:27:25.810Z","Included","auto","No","559","0","85154","144","85857","0.02"
"2025-09-22T10:24:03.433Z","Included","auto","No","2017","0","166675","146","168838","0.05"
"2025-09-22T10:22:59.579Z","Included","auto","No","2924","0","161029","318","164271","0.05"
"2025-09-22T10:21:27.825Z","Included","auto","No","6502","0","224817","489","231808","0.07"
"2025-09-22T10:20:38.335Z","Included","auto","No","3363","0","356398","543","360304","0.10"
"2025-09-22T10:19:37.649Z","Included","auto","No","12059","0","126203","304","138566","0.05"
"2025-09-22T10:17:43.109Z","Errored, Not Charged","auto","No","43957","120146","14346","9265","187714","0.26"
"2025-09-22T10:16:28.051Z","Errored, Not Charged","auto","No","0","403","129408","409","130220","0.04"
"2025-09-22T10:15:17.288Z","Included","auto","No","0","33306","96256","564","130126","0.07"
"2025-09-22T10:09:32.336Z","Included","auto","No","0","9731","631296","1322","642349","0.18"
"2025-09-22T10:08:00.374Z","Errored, Not Charged","auto","No","0","69312","104064","1223","174599","0.12"
"2025-09-22T10:05:15.399Z","Included","auto","No","57354","0","2623134","2897","2683385","0.74"
"2025-09-22T09:59:45.957Z","Included","auto","No","64143","103720","1265577","23940","1457380","0.67"
"2025-09-22T09:57:36.472Z","Included","auto","No","0","2737","298752","2416","303905","0.09"
"2025-09-22T09:56:23.365Z","Included","auto","No","0","1876","295552","1510","298938","0.09"
"2025-09-22T09:53:58.492Z","Included","auto","No","0","17747","391808","1338","410893","0.13"
"2025-09-22T09:53:18.094Z","Included","auto","No","0","838","129536","443","130817","0.04"
"2025-09-22T09:48:03.509Z","Included","auto","No","0","1575","128128","597","130300","0.04"
"2025-09-22T09:47:12.911Z","Included","auto","No","0","586","127744","1498","129828","0.04"
"2025-09-22T09:46:28.054Z","Included","auto","No","0","122169","127616","777","250562","0.19"
"2025-09-22T09:45:16.262Z","Included","auto","No","0","115153","127360","1653","244166","0.19"
"2025-09-22T09:36:18.198Z","Included","auto","No","138854","0","1591540","18836","1749230","0.68"
"2025-09-22T09:29:30.493Z","Errored, Not Charged","auto","No","65096","0","1054873","11132","1131101","0.41"
"2025-09-22T09:22:59.250Z","Included","auto","No","23833","0","2284119","14994","2322946","0.69"
"2025-09-22T09:15:26.162Z","Included","auto","No","34647","0","809779","10077","854503","0.31"
"2025-09-22T09:07:39.995Z","Errored, Not Charged","auto","No","67106","0","955444","12261","1034811","0.40"
"2025-09-22T09:03:23.360Z","Included","auto","No","14593","0","1697367","6718","1718678","0.48"
"2025-09-22T08:58:31.941Z","Included","auto","No","15957","0","1727800","6721","1750478","0.49"
"2025-09-22T08:55:42.079Z","Included","auto","No","14294","0","1401657","2773","1418724","0.38"
"2025-09-22T08:46:40.118Z","Included","auto","No","7291","0","638327","1527","647145","0.18"
"2025-09-22T08:36:26.841Z","Included","auto","No","61647","0","71839","467","133953","0.10"
"2025-09-22T08:35:23.934Z","Included","auto","No","2032","0","324924","880","327836","0.09"
"2025-09-22T08:34:34.836Z","Included","auto","No","4297","0","437545","1151","442993","0.12"
"2025-09-22T08:22:13.658Z","Included","auto","No","22497","0","1244229","5913","1272639","0.37"
"2025-09-22T08:13:49.563Z","Included","auto","No","30835","104994","44477","25000","205306","0.33"
"2025-09-22T08:07:40.476Z","Included","auto","No","0","1672","434048","1532","437252","0.12"
"2025-09-22T08:05:36.177Z","Included","auto","No","0","4371","422400","2650","429421","0.13"
"2025-09-22T08:01:23.383Z","Included","auto","No","0","134415","1187328","2539","1324282","0.48"
"2025-09-22T08:00:01.750Z","Included","auto","No","6876","0","591119","3184","601179","0.18"
"2025-09-22T07:56:56.432Z","Included","auto","No","10207","2506","446665","9793","469171","0.19"
"2025-09-22T07:54:12.543Z","Included","auto","No","14030","0","731162","7509","752701","0.25"
"2025-09-22T07:51:35.566Z","Included","auto","No","13964","0","742044","6457","762465","0.24"
"2025-09-22T07:45:42.268Z","Included","auto","No","45609","89579","12598","18099","165885","0.28"
"2025-09-22T07:41:29.074Z","Included","auto","No","209374","0","548858","12297","770529","0.47"
"2025-09-22T06:51:18.089Z","Included","auto","No","80418","85139","645822","19704","831083","0.49"
"2025-09-22T06:48:02.774Z","Included","auto","No","0","27897","190336","960","219193","0.09"
"2025-09-22T06:47:24.842Z","Included","auto","No","0","86549","6400","277","93226","0.11"
"2025-09-22T06:41:56.030Z","Included","auto","No","78853","0","7060","665","86578","0.10"
"2025-09-22T06:36:52.778Z","Errored, Not Charged","auto","No","40450","5053","907378","4493","957374","0.31"
"2025-09-22T06:35:23.119Z","Included","auto","No","414","4899","50228","488","56029","0.02"
"2025-09-22T06:32:18.694Z","Included","auto","No","38929","267468","60042","17863","384302","0.51"
"2025-09-22T06:27:56.161Z","Included","auto","No","481","5591","332160","525","338757","0.09"
"2025-09-22T06:25:40.489Z","Included","auto","No","10626","4404","1627592","1000","1643622","0.43"
"2025-09-22T06:24:46.766Z","Errored, Not Charged","auto","No","0","4320","321534","134","325988","0.09"
"2025-09-22T06:24:22.841Z","Errored, Not Charged","auto","No","0","0","0","0","0","0.00"
"2025-09-22T06:22:09.591Z","Errored, Not Charged","auto","No","496","3180","321038","151","324865","0.09"
"2025-09-22T06:19:59.756Z","Included","auto","No","11620","1","627796","609","640026","0.18"
"2025-09-22T06:19:47.739Z","Errored, Not Charged","auto","No","0","0","0","0","0","0.00"
"2025-09-22T06:18:47.701Z","Errored, Not Charged","auto","No","3049","2750","306369","236","312404","0.09"
"2025-09-22T06:17:11.751Z","Included","auto","No","459","2542","305910","504","309415","0.08"
"2025-09-22T06:14:20.786Z","Included","auto","No","18710","2379","582245","747","604081","0.18"
"2025-09-22T06:13:47.285Z","Errored, Not Charged","auto","No","2540","2164","284660","260","289624","0.08"
"2025-09-22T06:12:45.066Z","Included","auto","No","443","2146","284217","391","287197","0.08"
"2025-09-22T06:10:43.129Z","Included","auto","No","5796","1039","1124929","746","1132510","0.29"
"2025-09-22T06:10:32.840Z","Errored, Not Charged","auto","No","0","0","0","0","0","0.00"
"2025-09-22T06:09:47.707Z","Included","auto","No","324","954","278097","444","279819","0.07"
"2025-09-22T06:07:48.653Z","Included","auto","No","5631","704","820333","474","827142","0.22"
"2025-09-22T06:07:21.475Z","Included","auto","No","1105","662","271361","371","273499","0.07"
"2025-09-22T06:06:44.667Z","Included","auto","No","987","635","270374","466","272462","0.07"
"2025-09-22T06:05:57.166Z","Included","auto","No","216","550","270158","433","271357","0.07"
"2025-09-22T06:05:13.931Z","Errored, Not Charged","auto","No","299","124","539718","266","540407","0.14"
"2025-09-22T06:04:56.661Z","Errored, Not Charged","auto","No","452","124","269407","143","270126","0.07"
"2025-09-22T06:02:08.384Z","Included","auto","No","7396","200","1326389","6462","1340447","0.38"
"2025-09-22T05:56:40.973Z","Included","auto","No","9243","109","1279866","1802","1291020","0.34"
"2025-09-22T05:53:26.611Z","Included","auto","No","16410","129","1697534","2368","1716441","0.46"
"2025-09-22T05:50:24.608Z","Included","auto","No","11003","110","1379017","1238","1391368","0.37"
"2025-09-22T05:41:46.213Z","Included","auto","No","25353","234","2332426","6621","2364634","0.65"
"2025-09-22T05:38:52.830Z","Included","auto","No","642","108","199360","516","200626","0.05"
"2025-09-22T05:38:13.465Z","Included","auto","No","199360","108","0","535","200003","0.25"
"2025-09-22T05:17:11.902Z","Included","auto","No","655","109","180708","166","181638","0.05"
"2025-09-22T05:16:30.495Z","Included","auto","No","180708","115","0","542","181365","0.23"
"2025-09-22T02:49:28.491Z","Included","auto","No","150780","181","165535","4095","320591","0.25"
"2025-09-22T02:48:02.104Z","Errored, Not Charged","auto","No","0","0","0","0","0","0.00"
"2025-09-22T02:47:56.562Z","Errored, Not Charged","auto","No","0","0","0","0","0","0.00"
"2025-09-22T02:44:52.041Z","Errored, Not Charged","auto","No","0","0","0","0","0","0.00"
"2025-09-22T02:39:44.871Z","Included","auto","No","6198","644","615455","1089","623386","0.17"
"2025-09-22T02:33:10.337Z","Included","auto","No","47004","35461","796247","5354","884066","0.33"
"2025-09-22T02:19:34.555Z","Included","auto","No","109814","636","254161","4489","369100","0.23"
"2025-09-22T02:04:05.817Z","Included","auto","No","133698","294958","749626","26142","1204424","0.88"
"2025-09-22T01:54:46.724Z","Included","auto","No","17651","250","2404283","8124","2430308","0.67"
"2025-09-22T01:53:05.402Z","Included","auto","No","6425","258","1332943","3760","1343386","0.36"
"2025-09-22T01:51:28.189Z","Included","auto","No","314","181","330352","516","331363","0.09"
"2025-09-22T01:50:08.816Z","Errored, Not Charged","auto","No","0","0","0","0","0","0.00"
"2025-09-22T01:37:27.520Z","Included","auto","No","15638","239","3221298","11116","3248291","0.89"
"2025-09-22T01:32:28.670Z","Included","auto","No","40502","35039","860644","4052","940237","0.33"
"2025-09-22T01:27:33.383Z","Included","auto","No","13398","614","1309777","1931","1325720","0.36"
"2025-09-22T01:22:48.437Z","Included","auto","No","13753","198","744066","3577","761594","0.22"
"2025-09-22T01:20:29.884Z","Included","auto","No","7861","7263","1446616","6115","1467855","0.42"
"2025-09-22T01:18:23.567Z","Included","auto","No","8474","310","1167992","6064","1182840","0.34"
"2025-09-22T01:13:55.750Z","Included","auto","No","230166","75967","379111","3717","688961","0.50"
"2025-09-22T01:05:13.814Z","Included","auto","No","8674","13368","1292199","6613","1320854","0.39"
"2025-09-22T01:03:54.059Z","Included","auto","No","728","113","139826","764","141431","0.04"
"2025-09-22T00:58:33.665Z","Included","auto","No","14406","138","381383","4350","400277","0.14"
"2025-09-22T00:48:57.950Z","Included","auto","No","129444","132","218610","4124","352310","0.24"
"2025-09-22T00:40:13.526Z","Included","auto","No","210510","137","98709","3221","312577","0.31"
"2025-09-22T00:29:55.438Z","Included","auto","No","5473","144","381641","1691","388949","0.11"
"2025-09-22T00:28:42.593Z","Included","auto","No","1680","933","91160","980","94753","0.03"
"2025-09-22T00:27:01.514Z","Included","auto","No","1468","750","89692","930","92840","0.03"
"2025-09-22T00:24:50.960Z","Included","auto","No","89692","659","0","809","91160","0.12"
"2025-09-22T00:03:45.504Z","Included","auto","No","77724","134","432489","8881","519228","0.26"
"2025-09-21T23:59:45.181Z","Included","auto","No","68250","283130","319700","35515","706595","0.73"
"2025-09-21T23:53:53.431Z","Included","auto","No","23512","234","3311708","6831","3342285","0.90"
"2025-09-21T23:48:54.762Z","Included","auto","No","22047","651","3122379","6028","3151105","0.85"
"2025-09-21T23:39:34.959Z","Included","auto","No","16887","105","2629629","3545","2650166","0.70"
"2025-09-21T23:35:48.130Z","Included","auto","No","12723","150","1955465","4415","1972753","0.53"
"2025-09-21T23:30:00.051Z","Included","auto","No","11576","155","3504598","7965","3524294","0.94"
"2025-09-21T23:25:41.401Z","Included","auto","No","9835","135","764912","1241","776123","0.21"
"2025-09-21T23:24:03.680Z","Included","auto","No","544","135","253800","469","254948","0.07"
"2025-09-21T23:15:17.981Z","Included","auto","No","262755","148","936311","1543","1200757","0.57"
"2025-09-21T23:13:23.863Z","Included","auto","No","678","110","232638","429","233855","0.06"
"2025-09-21T23:01:23.238Z","Included","auto","No","448498","2204","636798","1884","1089384","0.73"
"2025-09-21T22:16:20.712Z","Included","auto","No","201954","4168","588864","2354","797340","0.42"
"2025-09-21T22:10:20.022Z","Included","auto","No","18913","194","2501169","5193","2525469","0.68"
"2025-09-21T22:08:22.635Z","Included","auto","No","14233","227","489305","4368","508133","0.17"
"2025-09-21T22:07:00.478Z","Included","auto","No","360","8780","155120","611","164871","0.05"
"2025-09-21T22:03:18.627Z","Included","auto","No","155120","132","1137529","2499","1295280","0.49"
"2025-09-21T21:51:56.383Z","Included","auto","No","5265","124","992872","1142","999403","0.26"
"2025-09-21T21:50:15.445Z","Included","auto","No","122270","164","356383","760","479577","0.25"
"2025-09-21T21:42:06.168Z","Included","auto","No","473","108","116813","365","117759","0.03"
"2025-09-21T21:41:16.841Z","Included","auto","No","5423","135","567218","853","573629","0.15"
"2025-09-21T21:37:22.420Z","Included","auto","No","6482","150","853475","1178","861285","0.23"
"2025-09-21T21:36:21.148Z","Included","auto","No","438","193","104470","423","105524","0.03"
"2025-09-21T21:34:29.257Z","Included","auto","No","486","2","103984","438","104910","0.03"
"2025-09-21T21:32:51.381Z","Included","auto","No","103984","3","0","319","104306","0.13"
"2025-09-21T20:25:33.717Z","Included","auto","No","2185","182","1298679","1111","1302157","0.33"
"2025-09-21T20:23:33.679Z","Errored, Not Charged","auto","No","674","272","319943","314","321203","0.08"
"2025-09-21T20:20:53.073Z","Included","auto","No","669","134","319274","537","320614","0.08"
"2025-09-21T20:09:16.072Z","Included","auto","No","332525","132","1755448","3013","2091118","0.87"
"2025-09-21T20:08:31.452Z","Included","auto","No","680","140","289416","491","290727","0.08"
"2025-09-21T20:00:28.846Z","Included","auto","No","297450","178","2432218","5139","2734985","1.01"
"2025-09-21T19:58:26.088Z","Included","auto","No","828","3432","531016","1163","536439","0.15"
"2025-09-21T19:57:26.316Z","Errored, Not Charged","auto","No","1466","120","1589385","541","1591512","0.40"
"2025-09-21T19:56:48.188Z","Included","auto","No","450","139","263592","494","264675","0.07"
"2025-09-21T19:55:55.317Z","Included","auto","No","456","99","263136","348","264039","0.07"
"2025-09-21T19:54:25.548Z","Included","auto","No","5941","135","1290620","1364","1298060","0.34"
"2025-09-21T19:49:41.565Z","Included","auto","No","34604","15798","3623192","5636","3679230","1.00"
"2025-09-21T19:46:42.966Z","Included","auto","No","11569","153","1282205","3094","1297021","0.35"
"2025-09-21T19:42:58.971Z","Included","auto","No","15761","187","2188808","3352","2208108","0.59"
"2025-09-21T19:37:16.807Z","Included","auto","No","22804","304","1789321","4328","1816757","0.50"
"2025-09-21T19:33:38.619Z","Included","auto","No","2947","241","339463","2448","345099","0.10"
"2025-09-21T19:29:03.083Z","Included","auto","No","14287","159","1429071","3667","1447184","0.40"
"2025-09-21T19:27:46.483Z","Included","auto","No","453","111","154770","441","155775","0.04"
"2025-09-21T19:26:27.205Z","Included","auto","No","3872","115","915495","1295","920777","0.24"
"2025-09-21T19:26:10.756Z","Included","auto","No","467","322","150431","488","151708","0.04"
"2025-09-21T19:21:38.692Z","Included","auto","No","18798","139","1359198","2805","1380940","0.38"
"2025-09-21T19:19:18.966Z","Included","auto","No","11715","156","990774","4738","1007383","0.29"
"2025-09-21T19:18:10.671Z","Included","auto","No","4332","113","464882","733","470060","0.13"
"2025-09-21T19:13:22.717Z","Included","auto","No","12051","137","540111","1456","553755","0.16"
"2025-09-21T19:12:05.857Z","Included","auto","No","2856","232","510279","1197","514564","0.14"
"2025-09-21T19:08:20.058Z","Included","auto","No","100679","204549","195503","9899","510630","0.49"
"2025-09-20T00:57:34.990Z","Included","auto","No","226636","173","2950801","6685","3184295","1.06"
"2025-09-20T00:54:31.517Z","Included","auto","No","36220","18016","2435298","8095","2497629","0.73"
"2025-09-20T00:52:26.149Z","Included","auto","No","6043","107","342596","5528","354274","0.13"
"2025-09-20T00:52:10.691Z","Included","auto","No","0","139","112740","472","113351","0.03"
"2025-09-20T00:32:40.546Z","Included","auto","No","116011","162","425572","3659","545404","0.27"
"2025-09-20T00:31:01.326Z","Included","auto","No","6373","440","292503","3980","303296","0.11"
"2025-09-20T00:25:23.398Z","Included","auto","No","5779","192","180254","901","187126","0.06"
"2025-09-20T00:23:26.854Z","Included","auto","No","1218","135","177742","665","179760","0.05"
"2025-09-20T00:17:11.105Z","Included","auto","No","4397","166","514621","2578","521762","0.15"
"2025-09-20T00:12:45.363Z","Included","auto","No","10474","108","1242723","3367","1256672","0.34"
"2025-09-20T00:12:27.850Z","Included","auto","No","0","173","73717","449","74339","0.02"
"2025-09-20T00:12:04.674Z","Included","auto","No","2676","125","215473","854","219128","0.06"
"2025-09-20T00:04:04.291Z","Included","auto","No","10598","154","584518","5588","600858","0.19"
"2025-09-20T00:03:01.369Z","Included","auto","No","48975","6415","64877","664","120931","0.09"
"2025-09-19T23:58:27.495Z","Included","auto","No","4146","234","251830","2678","258888","0.08"
"2025-09-19T23:56:48.419Z","Included","auto","No","6375","131","42656","220","49382","0.02"
"2025-09-19T23:55:10.826Z","Included","auto","No","47090","3235","136026","967","187318","0.10"
"2025-09-19T23:48:37.386Z","Errored, Not Charged","auto","No","131","57","41915","346","42449","0.01"
"2025-09-19T23:46:48.628Z","Included","auto","No","30447","212736","90201","13334","346718","0.41"
"2025-09-19T23:42:25.695Z","Included","auto","No","7786","577","2805100","4046","2817509","0.74"
"2025-09-19T23:40:05.131Z","Included","auto","No","3113","201","689375","2719","695408","0.19"
"2025-09-19T23:38:14.083Z","Included","auto","No","3972","126","2398052","1010","2403160","0.61"
"2025-09-19T23:37:29.599Z","Included","auto","No","758","196","339868","407","341229","0.09"
"2025-09-19T23:36:13.940Z","Included","auto","No","533","174","339335","580","340622","0.09"
"2025-09-19T23:35:05.077Z","Included","auto","No","2791","162","336544","367","339864","0.09"
"2025-09-19T23:33:46.371Z","Errored, Not Charged","auto","No","0","0","0","0","0","0.00"
"2025-09-19T23:33:25.185Z","Included","auto","No","462","3831","331751","497","336541","0.09"
"2025-09-19T23:26:49.942Z","Included","auto","No","7439","365","978809","5989","992602","0.29"
"2025-09-19T23:15:27.865Z","Included","auto","No","331280","371","1267635","6821","1606107","0.77"
"2025-09-19T22:51:43.779Z","Included","auto","No","633047","268","1534461","6768","2174544","1.22"
"2025-09-19T22:51:27.015Z","Included","auto","No","564","169","302647","354","303734","0.08"
"2025-09-19T22:42:10.562Z","Included","auto","No","308318","183","885819","6020","1200340","0.64"
"2025-09-19T22:33:09.034Z","Included","auto","No","303509","320","2014149","5876","2323854","0.92"
"2025-09-19T22:15:47.040Z","Errored, Not Charged","auto","No","13302","4795","1601500","5592","1625189","0.46"
"2025-09-19T22:07:49.957Z","Included","auto","No","6939","80","1800723","3613","1811355","0.48"
"2025-09-19T22:03:06.362Z","Included","auto","No","12419","162","2228591","9285","2250457","0.63"
"2025-09-19T21:54:21.463Z","Included","auto","No","247559","129","709635","4444","961767","0.51"
"2025-09-19T21:40:42.883Z","Included","auto","No","247024","344","2284070","7906","2539344","0.93"
"2025-09-19T21:34:30.902Z","Included","auto","No","6210","162","1534930","3750","1545052","0.41"
"2025-09-19T21:15:12.098Z","Included","auto","No","636360","167","619416","1846","1257789","0.96"
"2025-09-19T20:00:25.189Z","Included","auto","No","204055","8449","3314224","5387","3532115","1.13"
"2025-09-19T19:30:04.711Z","Included","auto","No","788","124","336472","519","337903","0.09"
"2025-09-19T19:27:19.663Z","Included","auto","No","168076","242","990991","2002","1161311","0.47"
"2025-09-19T19:07:49.429Z","Included","auto","No","161056","138","0","1681","162875","0.21"
"2025-09-19T10:04:51.267Z","Included","auto","No","9804","299","2162504","6040","2178647","0.59"
"2025-09-19T09:58:04.991Z","Included","auto","No","20948","106","1106143","20318","1147515","0.42"
"2025-09-19T09:23:52.208Z","Included","auto","No","376994","486","1364501","9134","1751115","0.87"
"2025-09-19T09:13:13.566Z","Errored, Not Charged","auto","No","74443","194","1792285","8136","1875058","0.59"
"2025-09-19T08:53:04.693Z","Included","auto","No","695553","80","1664761","3297","2363691","1.31"
"2025-09-19T08:48:20.768Z","Included","auto","No","3150","187","650761","269","654367","0.17"
"2025-09-19T08:46:35.458Z","Included","auto","No","68","118","325018","468","325672","0.08"
"2025-09-19T08:30:40.748Z","Included","auto","No","325018","149","3779230","3035","4107432","1.37"
"2025-09-19T08:01:07.148Z","Included","auto","No","10645","100","2405331","1521","2417597","0.62"
"2025-09-19T08:00:26.756Z","Included","auto","No","2777","189","587708","809","591483","0.16"
"2025-09-19T07:56:55.135Z","Included","auto","No","3954","129","870985","1134","876202","0.23"
"2025-09-19T07:53:11.518Z","Included","auto","No","12421","118","3110849","8473","3131861","0.84"
"2025-09-19T07:49:44.526Z","Included","auto","No","4909","120","1094379","1392","1100800","0.29"
"2025-09-19T07:49:03.226Z","Included","auto","No","936","122","271375","541","272974","0.07"
"2025-09-19T07:48:25.417Z","Included","auto","No","507","142","270868","791","272308","0.07"
"2025-09-19T07:45:05.077Z","Included","auto","No","3935","113","1070981","1072","1076101","0.28"
"2025-09-19T07:41:36.445Z","Included","auto","No","4122","119","790227","1595","796063","0.21"
"2025-09-19T07:36:48.301Z","Included","auto","No","13708","110","1536442","9569","1559829","0.46"
"2025-09-19T07:35:59.716Z","Included","auto","No","374","109","248729","539","249751","0.07"
"2025-09-19T07:31:58.923Z","Included","auto","No","9704","111","726004","6579","742398","0.23"
"2025-09-19T07:31:21.922Z","Included","auto","No","498","912","238527","412","240349","0.06"
"2025-09-19T07:29:56.608Z","Errored, Not Charged","auto","No","4977","121","940383","4105","949586","0.27"
"2025-09-19T07:29:38.913Z","Included","auto","No","437","124","233113","512","234186","0.06"
"2025-09-19T07:25:51.248Z","Included","auto","No","9748","172","1139641","7889","1157450","0.34"
"2025-09-19T07:22:27.872Z","Included","auto","No","14133","283","2810875","7581","2832872","0.77"
"2025-09-19T07:13:42.781Z","Included","auto","No","18923","174","4567182","7436","4593715","1.21"
"2025-09-19T07:13:01.580Z","Included","auto","No","506","181","189803","477","190967","0.05"
"2025-09-19T07:12:15.525Z","Included","auto","No","0","165","189803","338","190306","0.05"
"2025-09-19T07:08:05.333Z","Included","auto","No","8335","208","737763","5407","751713","0.23"
"2025-09-19T06:50:36.407Z","Included","auto","No","190595","8127","1332363","8295","1539380","0.63"
"2025-09-19T06:46:33.644Z","Included","auto","No","15273","157","1723643","7841","1746914","0.50"
"2025-09-19T06:45:52.932Z","Included","auto","No","512","830","147209","567","149118","0.04"
"2025-09-19T06:42:32.428Z","Included","auto","No","15986","4836","1691177","5594","1717593","0.48"
"2025-09-19T06:41:29.321Z","Included","auto","No","404","5391","130819","719","137333","0.04"
"2025-09-19T06:37:46.417Z","Included","auto","No","21139","6619","1197522","11881","1237161","0.41"
"2025-09-19T06:36:27.956Z","Included","auto","No","41","4683","109639","543","114906","0.04"
"2025-09-19T06:26:10.189Z","Included","auto","No","219081","184","216989","455","436709","0.33"
"2025-09-19T05:54:33.667Z","Included","auto","No","600","185","107087","423","108295","0.03"
"2025-09-19T05:54:06.568Z","Included","auto","No","278","218","106809","379","107684","0.03"
"2025-09-19T05:51:05.571Z","Included","auto","No","5564","118","1981596","2169","1989447","0.52"
"2025-09-19T05:50:33.734Z","Included","auto","No","547","114","100698","366","101725","0.03"
"2025-09-19T05:50:11.241Z","Included","auto","No","282","168","100416","376","101242","0.03"
"2025-09-19T05:48:44.494Z","Included","auto","No","3881","113","585072","632","589698","0.16"
"2025-09-19T05:48:08.524Z","Included","auto","No","449","180","96086","364","97079","0.03"
"2025-09-19T05:46:25.390Z","Included","auto","No","332","141","95754","305","96532","0.03"
"2025-09-19T05:45:25.064Z","Included","auto","No","3320","124","374119","681","378244","0.10"
"2025-09-19T05:44:07.915Z","Included","auto","No","1579","227","182106","463","184375","0.05"
"2025-09-19T05:42:07.625Z","Included","auto","No","11495","245","1188114","3226","1203080","0.33"
"2025-09-19T05:41:01.504Z","Included","auto","No","604","2","78756","365","79727","0.02"
"2025-09-19T05:40:28.920Z","Included","auto","No","67288","3","11468","316","79075","0.09"
"2025-09-19T05:38:51.381Z","Included","auto","No","26935","168","3139393","1943","3168439","0.83"
"2025-09-19T05:38:11.869Z","Included","auto","No","677","179","334551","385","335792","0.09"
"2025-09-19T05:37:22.433Z","Included","auto","No","635","219","333916","455","335225","0.09"
"2025-09-19T05:36:13.716Z","Included","auto","No","342","188","333574","444","334548","0.09"
"2025-09-19T05:34:25.713Z","Included","auto","No","11014","195","1305797","1206","1318212","0.35"
"2025-09-19T05:33:27.232Z","Included","auto","No","348","43","322560","401","323352","0.08"
"2025-09-19T05:33:08.241Z","Errored, Not Charged","auto","No","0","0","0","0","0","0.00"
"2025-09-19T05:31:40.468Z","Included","auto","No","9178","170","952164","799","962311","0.25"
"2025-09-19T05:30:52.737Z","Included","auto","No","312909","4358","0","581","317848","0.40"
"2025-09-19T05:23:46.056Z","Included","auto","No","761","169","311651","325","312906","0.08"
"2025-09-19T05:23:03.190Z","Included","auto","No","439","237","311212","521","312409","0.08"
"2025-09-19T05:20:20.080Z","Included","auto","No","10707","167","1519673","1719","1532266","0.40"
"2025-09-19T05:18:34.199Z","Included","auto","No","7437","177","2077478","1363","2086455","0.54"
"2025-09-19T05:17:56.675Z","Included","auto","No","581","1365","292487","384","294817","0.08"
"2025-09-19T05:16:25.887Z","Included","auto","No","508","161","291979","417","293065","0.08"
"2025-09-19T05:15:57.860Z","Included","auto","No","652","167","291327","338","292484","0.08"
"2025-09-19T05:15:08.756Z","Included","auto","No","159744","180","131583","469","291976","0.24"
"2025-09-19T05:13:47.745Z","Included","auto","No","131583","159233","0","508","291324","0.37"
"2025-09-19T05:01:32.375Z","Included","auto","No","618","181","130330","451","131580","0.04"
"2025-09-19T05:00:33.052Z","Included","auto","No","4045","175","126285","440","130945","0.04"
"2025-09-19T04:59:41.349Z","Included","auto","No","531","3537","125754","505","130327","0.04"
"2025-09-19T04:59:13.445Z","Included","auto","No","562","169","125192","359","126282","0.03"
"2025-09-19T04:58:39.570Z","Included","auto","No","810","182","124382","377","125751","0.03"
"2025-09-19T04:57:22.035Z","Included","auto","No","630","373","123752","434","125189","0.03"
"2025-09-19T04:57:04.987Z","Included","auto","No","0","230","123752","397","124379","0.03"
"2025-09-19T04:49:39.467Z","Included","auto","No","15917","249","1837646","7027","1860839","0.52"
"2025-09-19T04:48:01.434Z","Included","auto","No","703","167","107132","335","108337","0.03"
"2025-09-19T04:47:19.351Z","Included","auto","No","699","241","106433","459","107832","0.03"
"2025-09-19T04:45:58.533Z","Included","auto","No","445","329","105988","367","107129","0.03"
"2025-09-19T04:34:50.016Z","Included","auto","No","108004","169","195529","1257","304959","0.19"
"2025-09-19T04:34:32.337Z","Included","auto","No","321","183","97128","445","98077","0.03"
"2025-09-19T04:33:35.768Z","Included","auto","No","1098","211","288824","724","290857","0.08"
"2025-09-19T04:27:12.836Z","Included","auto","No","96030","8558","881189","4454","990231","0.38"
"2025-09-19T03:56:24.596Z","Included","auto","No","75679","212","690122","7274","773287","0.31"
"2025-09-19T02:37:07.707Z","Included","auto","No","44154","235524","278192","14908","572778","0.51"
"2025-09-19T02:24:16.445Z","Included","auto","No","12823","193","1760274","6620","1779910","0.50"
"2025-09-19T02:23:50.700Z","Included","auto","No","2303","192","117519","531","120545","0.04"
"2025-09-19T02:23:30.673Z","Included","auto","No","662","1745","116857","555","119819","0.04"
"2025-09-19T02:23:09.469Z","Included","auto","No","434","169","116423","490","117516","0.03"
"2025-09-19T02:22:32.758Z","Included","auto","No","116423","199","115761","648","233031","0.18"
"2025-09-19T01:55:44.309Z","Included","auto","No","6819","200","748733","3572","759324","0.22"
"2025-09-19T01:39:03.053Z","Included","auto","No","106419","197","200314","1307","308237","0.19"
"2025-09-19T01:38:03.455Z","Included","auto","No","364","228","99360","635","100587","0.03"
"2025-09-19T01:36:13.164Z","Included","auto","No","4175","174","290136","2900","297385","0.10"
"2025-09-19T01:35:24.751Z","Included","auto","No","961","251","94224","826","96262","0.03"
"2025-09-19T01:34:55.383Z","Included","auto","No","724","194","93500","764","95182","0.03"
"2025-09-19T01:25:55.808Z","Included","auto","No","6739","159","265087","1019","273004","0.08"
"2025-09-19T01:25:16.662Z","Included","auto","No","725","165","86036","712","87638","0.03"
"2025-09-19T01:22:08.399Z","Included","auto","No","710","214","85326","508","86758","0.03"
"2025-09-19T01:15:49.305Z","Included","auto","No","9477","175","560389","3911","573952","0.18"
"2025-09-19T01:11:24.563Z","Included","auto","No","5899","202","214486","3462","224049","0.08"
"2025-09-19T01:10:32.634Z","Included","auto","No","5791","197","64159","674","70821","0.03"
"2025-09-19T01:09:20.932Z","Included","auto","No","486","4975","63673","813","69947","0.03"
"2025-09-19T01:05:53.003Z","Included","auto","No","5799","9164","418321","5213","438497","0.15"
"2025-09-19T01:03:53.508Z","Included","auto","No","9714","187","408137","2844","420882","0.13"
"2025-09-19T01:03:28.494Z","Included","auto","No","603","253","47557","753","49166","0.02"
"2025-09-19T01:01:16.540Z","Included","auto","No","455","173","47102","431","48161","0.02"
"2025-09-19T00:57:03.201Z","Included","auto","No","2522","200","89572","845","93139","0.03"
"2025-09-19T00:56:10.313Z","Included","auto","No","2028","180","85789","580","88577","0.03"
"2025-09-19T00:54:24.444Z","Included","auto","No","42552","171","0","517","43240","0.06"
"2025-09-19T00:50:47.350Z","Included","auto","No","44227","223827","279255","10380","557689","0.47"
"2025-09-19T00:47:52.190Z","Included","auto","No","452","440","332399","439","333730","0.09"
"2025-09-19T00:46:59.399Z","Included","auto","No","332399","198","329801","1531","663929","0.51"
"2025-09-19T00:22:28.028Z","Included","auto","No","324211","8346","311379","4547","648483","0.52"
"2025-09-18T23:47:49.311Z","Included","auto","No","4456","181","599570","3659","607866","0.18"
"2025-09-18T23:46:35.991Z","Included","auto","No","713","177","298736","491","300117","0.08"
"2025-09-18T23:45:56.516Z","Included","auto","No","298736","169","0","540","299445","0.38"
"2025-09-18T23:24:49.049Z","Included","auto","No","5090","172","1152846","2914","1161022","0.31"
"2025-09-18T23:24:02.701Z","Included","auto","No","286647","461","0","500","287608","0.36"
"2025-09-18T23:05:27.209Z","Included","auto","No","4959","192","848324","2324","855799","0.23"
"2025-09-18T22:58:26.722Z","Included","auto","No","9261","380","3597037","4477","3611155","0.94"
"2025-09-18T22:56:24.640Z","Included","auto","No","6288","193","1877253","3484","1887218","0.50"
"2025-09-18T22:55:45.205Z","Included","auto","No","265735","14773","250654","551","531713","0.42"
"2025-09-18T22:48:15.873Z","Included","auto","No","250161","142","243556","6880","500739","0.42"
"2025-09-18T22:40:47.986Z","Included","auto","No","242527","195","0","831","243553","0.31"
"2025-09-18T22:29:17.840Z","Included","auto","No","6280","201","713823","5251","725555","0.22"
"2025-09-18T22:27:38.345Z","Included","auto","No","631","230","235091","653","236605","0.06"
"2025-09-18T22:25:50.509Z","Included","auto","No","235091","419","467032","808","703350","0.42"
"2025-09-18T22:17:15.525Z","Included","auto","No","13110","316","1357058","9373","1379857","0.41"
"2025-09-18T22:10:53.793Z","Included","auto","No","8620","274","1506298","3781","1518973","0.41"
"2025-09-18T22:07:33.712Z","Included","auto","No","582","1341","210365","532","212820","0.06"
"2025-09-18T22:04:54.621Z","Included","auto","No","6234","226","617461","4801","628722","0.19"
"2025-09-18T22:01:43.637Z","Included","auto","No","8736","2246","1798257","3768","1813007","0.49"
"2025-09-18T21:59:05.014Z","Errored, Not Charged","auto","No","24234","737","1401294","4616","1430881","0.41"
"2025-09-18T21:57:00.020Z","Included","auto","No","5726","407","669308","3659","679100","0.20"
"2025-09-18T21:53:03.420Z","Included","auto","No","5645","4860","644271","3349","658125","0.19"
"2025-09-18T21:52:26.640Z","Included","auto","No","510","159","159280","278","160227","0.04"
"2025-09-18T21:51:05.543Z","Included","auto","No","159280","376","313376","2952","475984","0.30"
"2025-09-18T21:41:14.063Z","Included","auto","No","8128","193","447103","3155","458579","0.14"
"2025-09-18T21:39:07.883Z","Included","auto","No","2354","200","289383","915","292852","0.08"
"2025-09-18T21:35:02.733Z","Included","auto","No","2274","187","284854","863","288178","0.08"
"2025-09-18T21:30:34.958Z","Included","auto","No","142096","185","140316","911","283508","0.22"
"2025-09-18T21:13:03.725Z","Included","auto","No","1921","351","275445","958","278675","0.08"
"2025-09-18T21:09:20.459Z","Included","auto","No","7201","186","394502","2788","404677","0.12"
"2025-09-18T21:05:31.280Z","Included","auto","No","3032","184","255524","814","259554","0.07"
"2025-09-18T21:03:40.693Z","Included","auto","No","2335","356","250578","854","254123","0.07"
"2025-09-18T21:02:23.402Z","Included","auto","No","5960","154","238991","2642","247747","0.08"
"2025-09-18T21:00:09.786Z","Included","auto","No","2656","186","233670","910","237422","0.07"
"2025-09-18T20:58:45.023Z","Included","auto","No","2627","185","228364","915","232091","0.07"
"2025-09-18T20:56:21.327Z","Included","auto","No","113874","401","112226","832","227333","0.18"
"2025-09-18T20:48:38.223Z","Included","auto","No","6315","197","320775","2327","329614","0.10"
"2025-09-18T20:46:36.437Z","Included","auto","No","2614","186","206083","916","209799","0.06"
"2025-09-18T20:45:08.066Z","Included","auto","No","2728","178","200714","823","204443","0.06"
"2025-09-18T20:44:22.275Z","Included","auto","No","648","169","99358","530","100705","0.03"
"2025-09-18T20:43:05.553Z","Included","auto","No","2536","363","194030","856","197785","0.06"
"2025-09-18T20:41:36.409Z","Included","auto","No","4926","152","184484","2196","191758","0.07"
"2025-09-18T20:41:06.363Z","Included","auto","No","576","167","91320","522","92585","0.03"
"2025-09-18T20:39:26.931Z","Included","auto","No","2331","177","178519","774","181801","0.05"
"2025-09-18T20:38:05.161Z","Included","auto","No","2491","189","173521","739","176940","0.05"
"2025-09-18T20:35:45.641Z","Included","auto","No","2456","352","168484","732","172024","0.05"
"2025-09-18T20:34:22.356Z","Included","auto","No","5606","157","323255","2593","331611","0.10"
"2025-09-18T20:30:34.041Z","Included","auto","No","78436","175","76565","719","155895","0.12"
"2025-09-18T20:11:03.159Z","Included","auto","No","2776","376","147016","684","150852","0.04"
"2025-09-18T20:03:56.388Z","Included","auto","No","2894","197","283786","914","287791","0.08"
"2025-09-18T20:01:38.832Z","Included","auto","No","1486","356","138240","419","140501","0.04"
"2025-09-18T20:00:38.870Z","Included","auto","No","68917","171","67163","1095","137346","0.11"
"2025-09-18T19:50:39.727Z","Included","auto","No","2284","379","129143","763","132569","0.04"
"2025-09-18T19:47:51.121Z","Included","auto","No","3512","321","184828","1482","190143","0.06"
"2025-09-18T19:46:09.997Z","Included","auto","No","4062","216","114115","3675","122068","0.06"
"2025-09-18T19:44:26.249Z","Included","auto","No","2282","181","109533","666","112662","0.03"
"2025-09-18T19:41:31.037Z","Included","auto","No","441","166","54087","308","55002","0.02"
"2025-09-18T19:41:01.857Z","Included","auto","No","54087","160","0","278","54525","0.07"
"2025-09-18T19:32:50.094Z","Included","auto","No","535","169","53061","319","54084","0.02"
"2025-09-18T19:31:17.105Z","Included","auto","No","303","178","52758","354","53593","0.02"
"2025-09-18T19:29:32.230Z","Included","auto","No","4237","186","97676","395","102494","0.03"
"2025-09-18T19:28:35.467Z","Included","auto","No","419","196","48102","435","49152","0.02"
"2025-09-18T19:24:31.773Z","Included","auto","No","2916","187","187595","859","191557","0.06"
"2025-09-18T19:23:44.564Z","Included","auto","No","45186","1323","0","529","47038","0.06"
"2025-09-18T19:15:55.078Z","Included","auto","No","487","181","44072","443","45183","0.01"
"2025-09-18T19:13:31.322Z","Included","auto","No","2804","198","82978","664","86644","0.03"
"2025-09-18T19:06:44.124Z","Included","auto","No","2898","266","77149","669","80982","0.03"
"2025-09-18T19:00:03.388Z","Included","auto","No","3038","224","71299","596","75157","0.03"
"2025-09-18T18:58:49.482Z","Included","auto","No","313","212","35019","421","35965","0.01"
"2025-09-18T18:58:17.092Z","Errored, Not Charged","auto","No","0","0","0","0","0","0.00"
"2025-09-18T18:53:01.402Z","Included","auto","No","34539","152908","124608","10208","322263","0.33"
"2025-09-18T04:53:53.308Z","Included","auto","No","3942","159","687954","2980","695035","0.19"
"2025-09-18T04:53:02.264Z","Included","auto","No","228037","168","0","433","228638","0.29"
"2025-09-18T02:31:35.600Z","Included","auto","No","227608","207","448501","4588","680904","0.42"
"2025-09-18T02:12:03.638Z","Included","auto","No","4665","189","1093972","2077","1100903","0.29"
"2025-09-18T02:06:20.731Z","Errored, Not Charged","auto","No","12886","170","1468266","10526","1491848","0.45"
"2025-09-18T02:04:37.161Z","Included","auto","No","487","168","203297","408","204360","0.05"
"2025-09-18T02:01:25.108Z","Included","auto","No","6282","185","596911","4904","608282","0.19"
"2025-09-18T01:58:50.446Z","Included","auto","No","5942","175","578502","4649","589268","0.18"
"2025-09-18T01:52:22.281Z","Included","auto","No","7656","202","557087","6017","570962","0.19"
"2025-09-18T01:50:22.788Z","Included","auto","No","7044","202","535087","5247","547580","0.17"
"2025-09-18T01:46:50.655Z","Included","auto","No","10999","169","1021386","8761","1041315","0.32"
"2025-09-18T01:43:22.955Z","Included","auto","No","5928","480","483435","4561","494404","0.16"
"2025-09-18T01:36:54.722Z","Included","auto","No","12427","417","1226794","8484","1248122","0.37"
"2025-09-18T01:30:15.173Z","Included","auto","No","11519","5656","561134","4040","582349","0.19"
"2025-09-18T01:26:44.877Z","Included","auto","No","5832","219","791943","3139","801133","0.22"
"2025-09-18T01:24:59.319Z","Included","auto","No","129668","174","0","379","130221","0.16"
"2025-09-18T01:15:14.791Z","Included","auto","No","2538","4320","508893","2733","518484","0.15"
"2025-09-18T01:10:48.601Z","Included","auto","No","8987","168","729769","6017","744941","0.23"
"2025-09-18T01:04:24.251Z","Included","auto","No","8969","168","332188","7106","348431","0.14"
"2025-09-18T01:02:46.107Z","Included","auto","No","6315","251","310898","4866","322330","0.12"
"2025-09-18T01:00:56.975Z","Included","auto","No","6682","189","291615","5440","303926","0.11"
"2025-09-18T00:56:38.759Z","Included","auto","No","14766","211","522386","11104","548467","0.22"
"2025-09-18T00:48:34.564Z","Included","auto","No","80373","430","997803","12841","1091447","0.43"
"2025-09-18T00:35:21.307Z","Included","auto","No","60887","221276","875386","25851","1183400","0.73"
"2025-09-18T00:24:17.676Z","Included","auto","No","13187","191","3749807","10545","3773730","1.02"
"2025-09-18T00:21:48.863Z","Included","auto","No","7765","389","2979195","4465","2991814","0.78"
"2025-09-18T00:19:12.432Z","Included","auto","No","1734","178","1304015","754","1306681","0.33"
"2025-09-18T00:18:31.404Z","Included","auto","No","325357","176","324887","496","650916","0.49"
"2025-09-18T00:10:17.733Z","Included","auto","No","537","163","323863","324","324887","0.08"
"2025-09-18T00:09:45.847Z","Included","auto","No","543","194","323320","343","324400","0.08"
"2025-09-18T00:08:58.605Z","Included","auto","No","529","195","322791","348","323863","0.08"
"2025-09-18T00:07:28.529Z","Included","auto","No","551","179","322240","350","323320","0.08"
"2025-09-18T00:06:44.430Z","Included","auto","No","448","213","321792","338","322791","0.08"
"2025-09-18T00:05:42.264Z","Included","auto","No","502","156","321290","292","322240","0.08"
"2025-09-18T00:05:23.148Z","Included","auto","No","440","168","320850","334","321792","0.08"
"2025-09-18T00:04:56.328Z","Included","auto","No","37","174","320813","266","321290","0.08"
"2025-09-18T00:02:34.491Z","Included","auto","No","2916","193","1595615","1351","1600075","0.41"
"2025-09-18T00:02:04.391Z","Included","auto","No","488","181","317409","322","318400","0.08"
"2025-09-18T00:01:39.458Z","Included","auto","No","559","182","316850","310","317901","0.08"
"2025-09-18T00:00:12.854Z","Included","auto","No","305382","231","11468","332","317413","0.39"
"2025-09-17T23:58:58.353Z","Included","auto","No","511","170","315844","329","316854","0.08"
"2025-09-17T23:57:53.202Z","Included","auto","No","522","161","315322","347","316352","0.08"
"2025-09-17T23:57:17.094Z","Included","auto","No","440","186","314882","333","315841","0.08"
"2025-09-17T23:56:30.502Z","Included","auto","No","522","155","314360","282","315319","0.08"
"2025-09-17T23:55:46.632Z","Included","auto","No","474","165","313886","354","314879","0.08"
"2025-09-17T23:55:09.720Z","Included","auto","No","521","165","313365","306","314357","0.08"
"2025-09-17T23:54:45.230Z","Included","auto","No","449","199","312916","319","313883","0.08"
"2025-09-17T23:53:47.241Z","Included","auto","No","488","157","312428","289","313362","0.08"
"2025-09-17T23:53:05.660Z","Included","auto","No","569","158","311859","327","312913","0.08"
"2025-09-17T23:52:24.221Z","Included","auto","No","542","171","311317","395","312425","0.08"
"2025-09-17T23:51:37.080Z","Included","auto","No","349","174","310968","365","311856","0.08"
"2025-09-17T23:50:43.759Z","Included","auto","No","1378","165","930345","642","932530","0.24"
"2025-09-17T23:50:19.625Z","Included","auto","No","309590","182","0","339","310111","0.39"
"2025-09-17T23:38:41.010Z","Included","auto","No","2471","173","921753","706","925103","0.24"
"2025-09-17T23:38:07.020Z","Included","auto","No","520","196","306214","319","307249","0.08"
"2025-09-17T23:35:39.263Z","Included","auto","No","542","188","305672","329","306731","0.08"
"2025-09-17T23:34:48.079Z","Included","auto","No","321","180","305351","359","306211","0.08"
"2025-09-17T23:32:55.756Z","Included","auto","No","2236","159","1215787","683","1218865","0.31"
"2025-09-17T23:32:25.358Z","Included","auto","No","509","172","302606","322","303609","0.08"
"2025-09-17T23:30:27.264Z","Included","auto","No","523","185","302083","321","303112","0.08"
"2025-09-17T23:29:19.079Z","Included","auto","No","589","187","301494","333","302603","0.08"
"2025-09-17T23:27:23.658Z","Included","auto","No","530","238","300964","348","302080","0.08"
"2025-09-17T23:25:42.259Z","Included","auto","No","458","204","300506","323","301491","0.08"
"2025-09-17T23:24:42.880Z","Included","auto","No","201","159","300305","296","300961","0.08"
"2025-09-17T23:18:46.817Z","Included","auto","No","10520","150","2943457","8435","2962562","0.80"
"2025-09-17T23:18:17.827Z","Included","auto","No","1160","158","577971","460","579749","0.15"
"2025-09-17T23:17:35.844Z","Included","auto","No","288625","383","0","335","289343","0.36"
"2025-09-17T22:43:50.317Z","Included","auto","No","530","156","287525","411","288622","0.08"
"2025-09-17T22:43:28.955Z","Included","auto","No","549","190","286976","337","288052","0.07"
"2025-09-17T22:42:18.069Z","Included","auto","No","393","180","286583","366","287522","0.07"
"2025-09-17T22:39:52.365Z","Included","auto","No","493","158","286090","232","286973","0.07"
"2025-09-17T22:38:44.273Z","Included","auto","No","828","155","285262","335","286580","0.07"
"2025-09-17T22:38:08.875Z","Included","auto","No","503","478","284759","347","286087","0.07"
"2025-09-17T22:35:24.324Z","Included","auto","No","223","193","284536","307","285259","0.07"
"2025-09-17T22:34:29.384Z","Included","auto","No","12185","171","1403480","1545","1417381","0.38"
"2025-09-17T22:33:29.321Z","Included","auto","No","578","8698","271773","447","281496","0.08"
"2025-09-17T22:28:56.794Z","Included","auto","No","764","192","271009","383","272348","0.07"
"2025-09-17T22:27:50.645Z","Included","auto","No","298","207","270711","554","271770","0.07"
"2025-09-17T22:25:36.845Z","Included","auto","No","1613","177","1079212","715","1081717","0.28"
"2025-09-17T22:20:21.663Z","Included","auto","No","19451","183","7762045","6364","7788043","2.00"
"2025-09-17T22:19:03.626Z","Included","auto","No","4457","243","1730390","1294","1736384","0.45"
"2025-09-17T22:17:37.884Z","Included","auto","No","3379","187","1945260","1415","1950241","0.50"
"2025-09-17T22:16:01.317Z","Included","auto","No","3776","161","1675224","1537","1680698","0.43"
"2025-09-17T22:12:48.744Z","Included","auto","No","7109","218","1875403","3502","1886232","0.50"
"2025-09-17T22:03:35.166Z","Included","auto","No","24046","331","4365089","16636","4406102","1.22"
"2025-09-17T21:59:30.804Z","Included","auto","No","7141","218","1831189","2788","1841336","0.48"
"2025-09-17T21:50:38.616Z","Included","auto","No","34296","193","6273481","16434","6324404","1.71"
"2025-09-17T21:46:35.254Z","Included","auto","No","9628","204","2418346","3024","2431202","0.64"
"2025-09-17T21:38:13.055Z","Included","auto","No","155815","427","5497295","10174","5663711","1.63"
"2025-09-17T21:15:54.792Z","Included","auto","No","4711","173","1155170","2429","1162483","0.31"
"2025-09-17T21:15:17.437Z","Included","auto","No","19331","18141","214669","509","252650","0.10"
"2025-09-17T21:12:46.293Z","Included","auto","No","481","206","106480","538","107705","0.03"
"2025-09-17T21:09:36.207Z","Included","auto","No","15033","168","1672109","6659","1693969","0.48"
"2025-09-17T21:08:55.796Z","Included","auto","No","363","178","91084","395","92020","0.03"
"2025-09-17T21:04:24.179Z","Included","auto","No","23301","223","2353086","9805","2386415","0.68"
"2025-09-17T21:00:41.651Z","Included","auto","No","16770","189","845309","6104","868372","0.27"
"2025-09-17T20:58:42.756Z","Included","auto","No","9489","388","409377","5182","424436","0.15"
"2025-09-17T20:56:26.247Z","Included","auto","No","3283","210","197670","1873","203036","0.07"
"2025-09-17T20:55:36.278Z","Included","auto","No","13680","457","96992","568","111697","0.05"
"2025-09-17T20:54:52.285Z","Included","auto","No","10413","144","116115","1077","127749","0.05"
"2025-09-17T20:54:21.698Z","Included","auto","No","928","497","46798","419","48642","0.02"
"2025-09-17T20:53:16.425Z","Included","auto","No","301","797","100044","337","101479","0.03"
"2025-09-17T20:52:24.213Z","Included","auto","No","6141","309","78508","636","85594","0.03"
"2025-09-17T20:50:42.751Z","Included","auto","No","22316","6","44586","778","67686","0.04"
"2025-09-17T20:48:51.172Z","Included","auto","No","88576","4387","104303","1630","198896","0.15"
"2025-09-17T20:47:34.331Z","Included","auto","No","13065","10452","159451","1168","184136","0.08"
"2025-09-17T20:45:15.766Z","Included","auto","No","7113","247","456503","4947","468810","0.15"
"2025-09-17T20:33:07.669Z","Included","auto","No","128359","153","903887","6252","1038651","0.42"
"2025-09-17T20:20:09.974Z","Included","auto","No","119716","233104","413323","20376","786519","0.67"
"2025-09-17T20:18:52.391Z","Included","auto","No","344835","150","680987","3063","1029035","0.62"
"2025-09-17T20:12:33.431Z","Included","auto","No","5668","173","1001432","2663","1009936","0.27"
"2025-09-17T20:09:42.273Z","Included","auto","No","6497","188","981316","3460","991461","0.27"
"2025-09-17T20:08:14.337Z","Included","auto","No","5991","201","1290592","2757","1299541","0.35"
"2025-09-17T20:06:00.336Z","Included","auto","No","4582","222","632002","2226","639032","0.18"
"2025-09-17T20:03:46.893Z","Included","auto","No","5714","216","936488","1616","944034","0.25"
"2025-09-17T20:01:42.940Z","Included","auto","No","312353","1597","310135","458","624543","0.47"
"2025-09-17T19:33:43.551Z","Included","auto","No","10627","2024","2743321","4840","2760812","0.73"
"2025-09-17T19:31:37.221Z","Included","auto","No","3665","2259","1188466","710","1195100","0.31"
"2025-09-17T19:30:38.523Z","Included","auto","No","3046","2206","585093","599","590944","0.16"
"2025-09-17T19:26:24.071Z","Included","auto","No","7249","3573","2026909","1581","2039312","0.53"
"2025-09-17T19:22:52.960Z","Included","auto","No","5608","2004","1130556","898","1139066","0.30"
"2025-09-17T19:18:23.607Z","Included","auto","No","1753","1589","277896","364","281602","0.08"
"2025-09-17T19:15:43.371Z","Included","auto","No","1831","1421","276065","335","279652","0.08"
"2025-09-17T19:15:06.385Z","Included","auto","No","1703","1496","274362","338","277899","0.07"
"2025-09-17T19:14:46.190Z","Included","auto","No","471","1398","273891","308","276068","0.07"
"2025-09-17T19:12:17.987Z","Included","auto","No","262423","346","1903020","4032","2169821","0.83"
"2025-09-17T19:10:51.658Z","Included","auto","No","266619","4978","523852","1719","797168","0.48"
"2025-09-17T19:00:10.971Z","Included","auto","No","319","1069","256811","335","258534","0.07"
"2025-09-17T18:56:20.515Z","Included","auto","No","4828","199","1016637","2080","1023744","0.27"
"2025-09-17T18:54:35.174Z","Errored, Not Charged","auto","No","3176","1228","749479","1300","755183","0.20"
"2025-09-17T18:52:25.596Z","Included","auto","No","248807","1630","1229931","2058","1482426","0.63"
"2025-09-17T08:39:19.059Z","Included","auto","No","21272","1292","3711635","10361","3744560","1.02"
"2025-09-17T08:38:26.264Z","Included","auto","No","3686","1265","436349","724","442024","0.12"
"2025-09-17T08:37:49.105Z","Included","auto","No","2165","961","215399","257","218782","0.06"
"2025-09-17T08:35:57.751Z","Included","auto","No","1170","1778","214229","384","217561","0.06"
"2025-09-17T08:34:40.049Z","Included","auto","No","6143","853","208086","314","215396","0.06"
"2025-09-17T08:33:56.641Z","Included","auto","No","2017","5830","206069","310","214226","0.06"
"2025-09-17T08:30:24.274Z","Included","auto","No","214","1753","205855","261","208083","0.06"
"2025-09-17T08:29:29.174Z","Included","auto","No","2338","111","816375","1044","819868","0.21"
"2025-09-17T08:28:36.979Z","Included","auto","No","1413","153","607747","658","609971","0.16"
"2025-09-17T08:26:50.322Z","Included","auto","No","8260","480","594554","1148","604442","0.17"
"2025-09-17T08:08:24.947Z","Included","auto","No","208414","1070","3605196","5554","3820234","1.20"
"2025-09-17T08:04:59.732Z","Included","auto","No","8282","145","3198292","3799","3210518","0.83"
"2025-09-17T08:03:49.088Z","Included","auto","No","3563","165","340954","3095","347777","0.11"
"2025-09-17T08:02:41.633Z","Included","auto","No","170223","137","0","368","170728","0.22"
"2025-09-17T07:37:21.448Z","Included","auto","No","17954","7694","1290442","5988","1322078","0.39"
"2025-09-17T07:35:46.477Z","Included","auto","No","7491","165","1632478","3918","1644052","0.44"
"2025-09-17T07:34:26.292Z","Included","auto","No","6955","182","1123615","3144","1133896","0.31"
"2025-09-17T07:32:41.670Z","Included","auto","No","9241","230","1591279","4162","1604912","0.43"
"2025-09-17T07:29:38.294Z","Included","auto","No","15479","314","1551622","4764","1572179","0.44"
"2025-09-17T07:27:24.976Z","Errored, Not Charged","auto","No","100371","400","1182617","4311","1287699","0.45"
"2025-09-17T07:25:29.987Z","Included","auto","No","17558","153","766715","2786","787212","0.23"
"2025-09-17T07:25:07.345Z","Included","auto","No","78714","115","99645","430","178904","0.13"
"2025-09-17T07:23:42.916Z","Included","auto","No","82732","72068","1083700","1944","1240444","0.48"
"2025-09-17T07:22:29.419Z","Included","auto","No","77132","424","229118","604","307278","0.16"
"2025-09-17T07:21:04.498Z","Included","auto","No","63580","366","157801","886","222633","0.12"
"2025-09-17T07:15:35.584Z","Included","auto","No","46031","94","777016","5153","828294","0.28"
"2025-09-17T07:14:30.021Z","Included","auto","No","25071","61","0","458","25590","0.03"
"2025-09-17T07:13:09.535Z","Included","auto","No","2950","6","75421","743","79120","0.03"
"2025-09-17T07:12:26.978Z","Included","auto","No","24237","2","0","332","24571","0.03"
"2025-09-17T07:09:03.597Z","Included","auto","No","3664","137","2995878","1419","3001098","0.76"
"2025-09-17T07:07:54.658Z","Included","auto","No","264","119","247568","329","248280","0.06"
"2025-09-17T07:07:24.970Z","Included","auto","No","1577","125","492130","402","494234","0.13"
"2025-09-17T07:04:13.399Z","Included","auto","No","6479","188","479300","6079","492046","0.16"
"2025-09-17T07:01:06.463Z","Included","auto","No","6312","193","3065545","3279","3075329","0.79"
"2025-09-17T06:59:22.010Z","Included","auto","No","4850","902","919747","3576","929075","0.26"
"2025-09-17T06:57:09.453Z","Included","auto","No","4496","273","1806514","2348","1813631","0.47"
"2025-09-17T06:54:55.968Z","Included","auto","No","5403","166","1544301","3187","1553057","0.41"
"2025-09-17T06:54:12.861Z","Included","auto","No","237","166","218214","325","218942","0.06"
"2025-09-17T06:50:15.580Z","Included","auto","No","5088","1168","644298","3605","654159","0.19"
"2025-09-17T06:37:51.287Z","Included","auto","No","214833","237","625686","840","841596","0.43"
"2025-09-17T06:36:42.807Z","Errored, Not Charged","auto","No","3769","179","822832","710","827490","0.21"
"2025-09-17T06:35:24.010Z","Included","auto","No","3567","246","401298","3260","408371","0.12"
"2025-09-17T06:31:33.500Z","Included","auto","No","12972","261","2302782","4422","2320437","0.62"
"2025-09-17T06:29:12.580Z","Included","auto","No","7388","422","1287721","4798","1300329","0.36"
"2025-09-17T06:26:01.849Z","Included","auto","No","11415","206","2607904","4575","2624100","0.69"
"2025-09-17T06:25:15.115Z","Included","auto","No","202","218","168580","161","169161","0.04"
"2025-09-17T06:23:19.483Z","Included","auto","No","4120","184","1325944","1747","1331995","0.35"
"2025-09-17T06:22:49.803Z","Included","auto","No","1804","572","489265","642","492283","0.13"
"2025-09-17T06:22:14.032Z","Included","auto","No","1580","273","484622","543","487018","0.13"
"2025-09-17T06:20:32.033Z","Included","auto","No","161076","178","318364","2781","482399","0.30"
"2025-09-17T05:41:25.591Z","Included","auto","No","8273","186","454028","7583","470070","0.17"
"2025-09-17T05:40:56.799Z","Included","auto","No","496","201","149213","256","150166","0.04"
"2025-09-17T05:40:01.913Z","Included","auto","No","744","220","148469","273","149706","0.04"
"2025-09-17T05:39:10.351Z","Included","auto","No","125","441","148344","300","149210","0.04"
"2025-09-17T05:36:50.434Z","Included","auto","No","2022","238","1031307","861","1034428","0.27"
"2025-09-17T05:35:23.144Z","Included","auto","No","713","185","145609","173","146680","0.04"
"2025-09-17T05:34:54.074Z","Included","auto","No","487","520","145122","190","146319","0.04"
"2025-09-17T05:33:37.164Z","Included","auto","No","774","186","144348","298","145606","0.04"
"2025-09-17T05:33:08.555Z","Included","auto","No","532","450","143816","321","145119","0.04"
"2025-09-17T05:32:29.426Z","Included","auto","No","33","323","143783","206","144345","0.04"
"2025-09-17T05:31:54.058Z","Included","auto","No","2054","412","283611","783","286860","0.08"
"2025-09-17T05:31:03.834Z","Included","auto","No","1393","222","704048","523","706186","0.18"
"2025-09-17T05:29:40.803Z","Included","auto","No","3836","157","273390","3430","280813","0.09"
"2025-09-17T05:29:25.374Z","Included","auto","No","970","161","135530","226","136887","0.04"
"2025-09-17T05:26:57.390Z","Included","auto","No","902","712","134628","255","136497","0.04"
"2025-09-17T05:24:07.644Z","Included","auto","No","151","590","134477","309","135527","0.04"
"2025-09-17T05:20:57.306Z","Included","auto","No","4410","218","659017","2050","665695","0.18"
"2025-09-17T05:20:24.732Z","Included","auto","No","452","238","129615","187","130492","0.03"
"2025-09-17T05:19:34.632Z","Included","auto","No","549","226","129066","223","130064","0.03"
"2025-09-17T05:18:53.290Z","Included","auto","No","659","222","128407","324","129612","0.04"
"2025-09-17T05:18:11.713Z","Included","auto","No","682","257","127725","399","129063","0.04"
"2025-09-17T05:17:18.604Z","Included","auto","No","189","450","127536","229","128404","0.03"
"2025-09-17T05:14:45.326Z","Included","auto","No","15748","2893","1202171","4723","1225535","0.35"
"2025-09-17T05:12:41.285Z","Included","auto","No","26663","313","475179","946","503101","0.16"
"2025-09-17T05:07:30.200Z","Included","auto","No","12931","580","1690854","8778","1713143","0.49"
"2025-09-17T05:06:07.610Z","Included","auto","No","0","564","72194","365","73123","0.02"
"2025-09-17T05:05:10.749Z","Errored, Not Charged","auto","No","534","573","70642","394","72143","0.02"
"2025-09-17T05:03:22.285Z","Included","auto","No","13348","543","176217","974","191082","0.07"
"2025-09-17T05:02:43.127Z","Included","auto","No","57294","603","0","425","58322","0.07"
"2025-09-17T04:53:19.110Z","Included","auto","No","11383","532","420947","7872","440734","0.17"
"2025-09-17T04:49:56.127Z","Included","auto","No","876","1945","44565","382","47768","0.02"
"2025-09-17T04:49:18.577Z","Included","auto","No","436","565","44129","308","45438","0.01"
"2025-09-17T04:44:27.661Z","Included","auto","No","44129","20","997837","7396","1049382","0.35"
"2025-09-17T04:35:14.572Z","Errored, Not Charged","auto","No","7835","107","1716625","6542","1731109","0.48"
"2025-09-17T04:34:38.014Z","Included","auto","No","597","463","339210","611","340881","0.09"
"2025-09-17T04:29:05.459Z","Included","auto","No","3951","126","4722284","1936","4728297","1.20"
"2025-09-17T04:28:15.736Z","Included","auto","No","837","141","334422","571","335971","0.09"
"2025-09-17T04:27:16.535Z","Included","auto","No","896","195","333526","639","335256","0.09"
"2025-09-17T04:25:45.362Z","Included","auto","No","1025","144","332501","749","334419","0.09"
"2025-09-17T04:24:21.340Z","Included","auto","No","5879","144","326622","878","333523","0.09"
"2025-09-17T04:22:57.699Z","Included","auto","No","567","5236","326055","640","332498","0.09"
"2025-09-17T04:18:24.005Z","Included","auto","No","22322","4814","2191764","5001","2223901","0.61"
"2025-09-17T04:16:22.279Z","Included","auto","No","612","171","303121","674","304578","0.08"
"2025-09-17T04:13:48.419Z","Included","auto","No","10685","2657","1795450","7582","1816374","0.51"
"2025-09-17T04:10:04.383Z","Included","auto","No","10545","2070","3160634","3956","3177205","0.83"
"2025-09-17T04:06:33.029Z","Included","auto","No","17636","5579","1931276","11681","1966172","0.58"
"2025-09-17T04:00:49.658Z","Included","auto","No","10758","118","5927372","5898","5944146","1.53"
"2025-09-17T03:58:00.699Z","Included","auto","No","7894","164","2750316","5610","2763984","0.73"
"2025-09-17T03:56:00.128Z","Included","auto","No","31697","21688","2609143","3141","2665669","0.74"
"2025-09-17T03:54:05.268Z","Included","auto","No","7170","129","1685654","3601","1696554","0.45"
"2025-09-17T03:50:22.179Z","Included","auto","No","13998","225","3197099","8363","3219685","0.87"
"2025-09-17T03:47:50.613Z","Included","auto","No","3821","142","761141","2116","767220","0.21"
"2025-09-17T03:46:49.483Z","Included","auto","No","302","157","188615","465","189539","0.05"
"2025-09-17T03:43:56.654Z","Included","auto","No","3977","621","1118948","1763","1125309","0.30"
"2025-09-17T03:42:38.873Z","Included","auto","No","3392","532","915256","1752","920932","0.24"
"2025-09-17T03:41:34.917Z","Included","auto","No","3422","552","897995","1581","903550","0.24"
"2025-09-17T03:40:02.186Z","Included","auto","No","4099","403","1231908","2144","1238554","0.33"
"2025-09-17T03:37:25.017Z","Included","auto","No","7336","153","1019374","3852","1030715","0.29"
"2025-09-17T03:34:39.991Z","Included","auto","No","155411","439","1482353","2942","1641145","0.58"
"2025-09-17T03:30:57.823Z","Included","auto","No","160017","232","1225324","7790","1393363","0.55"
"2025-09-17T02:38:47.125Z","Included","auto","No","9919","10944","1415089","15632","1451584","0.47"
"2025-09-17T02:37:33.991Z","Included","auto","No","98631","0","735898","1443","835972","0.32"
"2025-09-17T02:36:06.439Z","Included","auto","No","4358","0","907282","2069","913709","0.24"
"2025-09-17T02:31:29.613Z","Included","auto","No","14703","0","993031","10727","1018461","0.33"
"2025-09-17T02:19:20.078Z","Included","auto","No","20929","0","1397012","12927","1430868","0.45"
"2025-09-17T02:17:20.235Z","Included","auto","No","1435","0","308819","579","310833","0.08"
"2025-09-17T02:16:20.226Z","Included","auto","No","4584","0","412849","2226","419659","0.12"
"2025-09-17T02:14:01.129Z","Included","auto","No","2878","0","441920","1133","445931","0.12"
"2025-09-17T02:10:47.715Z","Included","auto","No","2124","0","314285","908","317317","0.09"
"2025-09-17T02:09:27.997Z","Included","auto","No","4853","0","296809","2493","304155","0.10"
"2025-09-17T02:03:17.948Z","Included","auto","No","3251","0","272286","1211","276748","0.08"
"2025-09-17T01:58:16.307Z","Included","auto","No","13749","0","201155","456","215360","0.07"
"2025-09-17T01:45:41.720Z","Included","auto","No","53922","71021","452194","21370","598507","0.40"
"2025-09-17T01:41:00.999Z","Included","auto","No","14140","0","1738300","3227","1755667","0.47"
"2025-09-17T01:39:14.849Z","Included","auto","No","12213","0","1332520","3189","1347922","0.37"
"2025-09-17T01:37:15.935Z","Included","auto","No","177688","2080","792298","3216","975282","0.44"
"2025-09-17T01:25:52.528Z","Included","auto","No","22331","0","1152900","2234","1177465","0.33"
"2025-09-17T01:20:36.056Z","Included","auto","No","19066","0","2838905","4577","2862548","0.76"
"2025-09-17T01:15:29.944Z","Included","auto","No","19058","21361","469564","2711","512694","0.18"
"2025-09-17T01:07:44.777Z","Included","auto","No","24275","0","582792","6567","613634","0.22"
"2025-09-17T01:06:01.151Z","Included","auto","No","8622","0","620157","3604","632383","0.19"
"2025-09-17T01:04:17.233Z","Included","auto","No","2411","0","83595","177","86183","0.02"
"2025-09-17T00:59:47.689Z","Included","auto","No","12824","0","70773","470","84067","0.04"
"2025-09-17T00:54:41.892Z","Included","auto","No","24380","0","342826","5671","372877","0.15"
"2025-09-17T00:52:02.985Z","Included","auto","No","24071","0","168082","10759","202912","0.14"
"2025-09-17T00:50:40.023Z","Included","auto","No","14006","381104","210881","11333","617324","0.61"
"2025-09-17T00:47:46.637Z","Included","auto","No","19193","0","1195261","10385","1224839","0.39"
"2025-09-17T00:42:22.805Z","Included","auto","No","35123","0","3454428","11557","3501108","0.98"
"2025-09-17T00:29:13.264Z","Included","auto","No","93832","0","1953444","12879","2060155","0.68"
"2025-09-17T00:25:24.204Z","Included","auto","No","10761","0","435990","1567","448318","0.13"
"2025-09-17T00:17:28.850Z","Included","auto","No","38170","55842","401733","22993","518738","0.36"
"2025-09-17T00:14:13.010Z","Included","auto","No","13762","1983","1776728","7401","1799874","0.51"
"2025-09-17T00:11:45.016Z","Included","auto","No","5402","0","1736904","2115","1744421","0.45"
"2025-09-17T00:08:37.796Z","Included","auto","No","50811","0","927428","2803","981042","0.31"
"2025-09-16T23:58:33.628Z","Errored, Not Charged","auto","No","300884","22444","3052407","39329","3415064","1.40"
"2025-09-16T23:34:47.087Z","Included","auto","No","35696","0","5092554","7023","5135273","1.36"
"2025-09-16T23:33:20.390Z","Included","auto","No","56490","0","862702","1751","920943","0.30"
"2025-09-16T22:56:04.670Z","Included","auto","No","16193","0","1277672","1981","1295846","0.35"
"2025-09-16T22:44:59.600Z","Errored, Not Charged","auto","No","35584","0","172813","969","209366","0.09"
"2025-09-16T22:07:17.551Z","Included","auto","No","105764","0","984414","710","1090888","0.38"
"2025-09-16T21:27:34.383Z","Included","auto","No","17950","0","1546994","2820","1567764","0.43"
"2025-09-16T21:24:46.909Z","Included","auto","No","12880","0","1317243","7532","1337655","0.39"
"2025-09-16T21:20:52.888Z","Errored, Not Charged","auto","No","30615","0","1005588","13553","1049756","0.37"
"2025-09-16T21:16:30.488Z","Errored, Not Charged","auto","No","44561","0","920028","7141","971730","0.33"
"2025-09-16T21:13:02.987Z","Included","auto","No","13704","0","722543","12570","748817","0.27"
"2025-09-16T21:10:12.274Z","Included","auto","No","11303","0","1521356","5194","1537853","0.43"
"2025-09-16T21:05:00.752Z","Included","auto","No","17003","0","615691","11380","644074","0.24"
"2025-09-16T21:01:29.183Z","Included","auto","No","16705","0","711717","8541","736963","0.25"
"2025-09-16T20:57:59.895Z","Included","auto","No","22824","2096","741533","7812","774265","0.26"
"2025-09-16T20:55:11.811Z","Included","auto","No","19011","0","942302","8652","969965","0.31"
"2025-09-16T20:52:04.369Z","Included","auto","No","16785","63503","145972","10039","236299","0.20"
"2025-09-16T20:49:59.559Z","Included","auto","No","3441","0","521776","1114","526331","0.14"
"2025-09-16T20:43:59.952Z","Included","auto","No","97287","0","1204553","12121","1313961","0.50"
"2025-09-16T20:42:48.033Z","Included","auto","No","1966","0","96069","263","98298","0.03"
"2025-09-16T20:39:12.305Z","Included","auto","No","3014","0","763803","940","767757","0.20"
"2025-09-16T20:36:04.476Z","Included","auto","No","19605","0","2596259","4447","2620311","0.70"
"2025-09-16T20:31:16.993Z","Errored, Not Charged","auto","No","13397","0","1846235","1662","1861294","0.49"
"2025-09-16T20:28:25.213Z","Included","auto","No","13264","0","1110352","10512","1134128","0.36"
"2025-09-16T20:26:47.965Z","Included","auto","No","6505","0","1406121","1482","1414108","0.37"
"2025-09-16T20:25:47.374Z","Included","auto","No","10638","0","569313","1653","581604","0.17"
"2025-09-16T20:24:20.964Z","Included","auto","No","7132","0","389320","6608","403060","0.15"
"2025-09-16T20:22:46.174Z","Included","auto","No","16248","0","739942","4007","760197","0.23"
"2025-09-16T20:20:11.097Z","Errored, Not Charged","auto","No","18621","62221","58588","8433","147863","0.17"
"2025-09-16T20:15:46.598Z","Included","auto","No","9990","0","1000580","8250","1018820","0.31"
"2025-09-16T20:10:54.782Z","Included","auto","No","13775","2702","882823","13132","912432","0.32"
"2025-09-16T20:07:09.184Z","Included","auto","No","25958","0","1376870","15208","1418036","0.47"
"2025-09-16T20:02:32.276Z","Included","auto","No","24074","0","1009240","7035","1040349","0.32"
"2025-09-16T20:01:55.474Z","Included","auto","No","1708","670","124109","1139","127626","0.04"
"2025-09-16T19:56:51.517Z","Included","auto","No","33629","0","523996","5605","563230","0.21"
"2025-09-16T19:52:55.536Z","Included","auto","No","21748","0","510154","9038","540940","0.21"
"2025-09-16T19:52:09.112Z","Errored, Not Charged","auto","No","0","0","0","0","0","0.00"
"2025-09-16T19:46:51.900Z","Included","auto","No","16444","90174","121185","5757","233560","0.20"
"2025-09-15T05:42:32.772Z","Included","auto","No","12823","0","153352","522","166697","0.05"
"2025-09-15T05:37:31.194Z","Included","auto","No","98672","171008","416246","13055","698981","0.27"
"2025-09-15T05:24:04.571Z","Included","auto","No","3381","72775","95844","8257","180257","0.07"
"2025-09-15T05:16:43.247Z","Included","auto","No","14836","155920","1835487","18343","2024586","0.56"
"2025-09-15T05:16:17.721Z","Errored, Not Charged","auto","No","0","0","0","0","0","0.00"
"2025-09-15T05:08:53.737Z","Included","auto","No","75993","0","252261","1471","329725","0.14"
"2025-09-15T04:56:07.399Z","Included","auto","No","20268","0","1111510","3232","1135010","0.31"
"2025-09-15T04:50:06.499Z","Included","auto","No","11180","0","969772","6612","987564","0.28"
"2025-09-15T04:49:12.603Z","Included","auto","No","6019","0","43464","499","49982","0.02"
"2025-09-15T04:42:40.704Z","Included","auto","No","39032","0","1376619","5006","1420657","0.40"
"2025-09-15T04:42:05.541Z","Errored, Not Charged","auto","No","0","64718","0","0","64718","0.01"
"2025-09-15T04:34:08.637Z","Included","auto","No","29950","844466","3578979","26251","4479646","1.06"
"2025-09-15T04:33:26.231Z","Included","auto","No","3999","0","514919","1547","520465","0.14"
"2025-09-15T04:32:41.469Z","Included","auto","No","4279","0","655268","1017","660564","0.17"
"2025-09-15T04:32:01.237Z","Included","auto","No","3117","0","627675","1098","631890","0.16"
"2025-09-15T04:29:33.263Z","Included","auto","No","18195","0","2402516","4672","2425383","0.64"
"2025-09-15T04:26:24.094Z","Included","auto","No","19000","0","766052","4817","789869","0.23"
"2025-09-15T04:20:38.830Z","Errored, Not Charged","auto","No","54301","351518","342555","33345","781719","0.32"
"2025-09-15T04:17:57.536Z","Errored, Not Charged","auto","No","11389","144818","724562","21261","902030","0.25"
"2025-09-15T04:15:20.951Z","Errored, Not Charged","auto","No","96700","203465","489242","14574","803981","0.30"
"2025-09-15T02:55:58.599Z","Included","auto","No","27284","0","2447037","7473","2481794","0.67"
"2025-09-15T02:49:02.385Z","Included","auto","No","14497","0","444545","14756","473798","0.18"
"2025-09-15T02:47:42.723Z","Included","auto","No","2671","0","301679","4727","309077","0.10"
"2025-09-15T02:46:08.325Z","Included","auto","No","11462","0","144248","1469","157179","0.05"
"2025-09-15T02:30:58.796Z","Errored, Not Charged","auto","No","22137","74626","161136","9891","267790","0.09"
"2025-09-15T02:24:52.948Z","Errored, Not Charged","auto","No","9372","236526","861114","27971","1134983","0.34"
"2025-09-15T02:22:56.207Z","Included","auto","No","98123","293126","788159","29812","1209220","0.45"
"2025-09-15T01:17:42.470Z","Included","auto","No","19571","0","801427","7638","828636","0.25"
"2025-09-15T01:14:07.960Z","Included","auto","No","1381","0","70216","544","72141","0.02"
"2025-09-15T01:08:42.796Z","Errored, Not Charged","auto","No","78354","460388","1795382","56792","2390916","0.74"
"2025-09-15T01:04:30.404Z","Errored, Not Charged","auto","No","14421","190772","1429052","13828","1648073","0.45"
"2025-09-15T01:03:33.587Z","Included","auto","No","6196","1862","248921","2664","259643","0.09"
"2025-09-15T00:59:51.592Z","Included","auto","No","4163","1741","403992","3082","412978","0.12"
"2025-09-15T00:54:04.545Z","Included","auto","No","5181","4686","532014","4208","546089","0.17"
"2025-09-15T00:52:08.854Z","Included","auto","No","4144","0","643085","2459","649688","0.17"
"2025-09-15T00:46:58.935Z","Included","auto","No","14580","0","1361373","8845","1384798","0.39"
"2025-09-15T00:41:46.411Z","Included","auto","No","18803","0","600500","15312","634615","0.23"
"2025-09-15T00:41:01.469Z","Included","auto","No","13090","0","137616","853","151559","0.05"
"2025-09-15T00:35:18.036Z","Included","auto","No","386","0","22872","252","23510","0.01"
"2025-09-15T00:34:40.164Z","Included","auto","No","717","0","22156","259","23132","0.01"
"2025-09-15T00:31:46.624Z","Errored, Not Charged","auto","No","15097","0","7060","431","22588","0.02"
"2025-09-14T23:47:36.885Z","Errored, Not Charged","auto","No","11872","0","1421873","6258","1440003","0.39"
"2025-09-14T23:46:38.730Z","Included","auto","No","1667","133667","387274","14706","537314","0.17"
"2025-09-14T23:45:18.761Z","Included","auto","No","25740","0","705684","2061","733485","0.21"
"2025-09-14T23:44:45.818Z","Included","auto","No","3500","0","566257","1000","570757","0.15"
"2025-09-14T23:43:38.437Z","Errored, Not Charged","auto","No","14565","0","109103","1630","125298","0.05"
"2025-09-14T23:41:34.737Z","Included","auto","No","10831","0","591607","6539","608977","0.18"
"2025-09-14T23:41:11.451Z","Included","auto","No","2926","0","82519","808","86253","0.03"
"2025-09-14T23:38:38.149Z","Included","auto","No","2149","19524","38769","2275","62717","0.02"
"2025-09-14T23:35:30.454Z","Included","auto","No","3639","0","183438","2784","189861","0.06"
"2025-09-14T23:33:30.707Z","Included","auto","No","1422","0","137475","855","139752","0.04"
"2025-09-14T23:31:53.453Z","Included","auto","No","3299","0","320120","1960","325379","0.09"
"2025-09-14T23:23:26.375Z","Errored, Not Charged","auto","No","23378","90743","261734","1520","377375","0.11"
"2025-09-14T23:18:28.077Z","Errored, Not Charged","auto","No","9353","201811","1592614","15130","1818908","0.45"
"2025-09-14T23:17:55.315Z","Errored, Not Charged","auto","No","691","97214","218259","8811","324975","0.08"
"2025-09-14T23:17:25.465Z","Errored, Not Charged","auto","No","1284","194712","317172","563","513731","0.09"
"2025-09-14T23:15:07.711Z","Errored, Not Charged","auto","No","7301","231316","1183668","21630","1443915","0.38"
"2025-09-14T23:13:14.344Z","Errored, Not Charged","auto","No","41750","136389","1026442","7434","1212015","0.35"
"2025-09-14T22:55:52.942Z","Errored, Not Charged","auto","No","85694","0","1228646","5367","1319707","0.41"
"2025-09-14T22:54:13.981Z","Included","auto","No","912","0","57154","344","58410","0.02"
"2025-09-14T22:52:12.250Z","Included","auto","No","3649","0","53506","386","57541","0.02"
"2025-09-14T22:51:41.073Z","Included","auto","No","476","0","53031","294","53801","0.01"
"2025-09-14T22:50:59.068Z","Included","auto","No","479","0","52553","320","53352","0.01"
"2025-09-14T22:50:38.583Z","Included","auto","No","474","0","52080","350","52904","0.01"
"2025-09-14T22:50:15.206Z","Included","auto","No","1020","0","51061","343","52424","0.02"
"2025-09-14T22:48:32.312Z","Included","auto","No","445","0","50617","329","51391","0.01"
"2025-09-14T22:47:33.351Z","Included","auto","No","469","0","50149","289","50907","0.01"
"2025-09-14T22:47:21.745Z","Included","auto","No","836","0","49314","343","50493","0.01"
"2025-09-14T22:43:12.769Z","Included","auto","No","1304","0","48011","351","49666","0.01"
"2025-09-14T22:40:21.167Z","Included","auto","No","1057","0","46955","391","48403","0.01"
"2025-09-14T22:38:27.793Z","Included","auto","No","1119","0","45837","345","47301","0.01"
"2025-09-14T22:33:19.148Z","Included","auto","No","8153","0","317934","2905","328992","0.10"
"2025-09-14T22:33:07.747Z","Included","auto","No","594","0","37099","347","38040","0.01"
"2025-09-14T22:32:33.176Z","Included","auto","No","659","0","36441","325","37425","0.01"
"2025-09-14T22:27:02.889Z","Included","auto","No","745","0","35697","353","36795","0.01"
"2025-09-14T22:23:43.787Z","Included","auto","No","498","0","35200","357","36055","0.01"
"2025-09-14T22:23:02.833Z","Included","auto","No","28141","0","7060","351","35552","0.03"
"2025-09-14T22:12:11.064Z","Included","auto","No","7391","0","400688","1984","410063","0.12"
"2025-09-14T22:10:14.016Z","Included","auto","No","1337","0","23176","323","24836","0.01"
"2025-09-14T22:03:54.863Z","Included","auto","No","16117","0","7060","564","23741","0.02"
"2025-09-14T21:38:10.853Z","Errored, Not Charged","auto","No","13098","205777","7881","6452","233208","0.07"
"2025-09-14T21:35:52.930Z","Included","auto","No","4287","0","322929","499","327715","0.09"
"2025-09-14T21:33:49.982Z","Included","auto","No","11967","0","582023","2300","596290","0.17"
"2025-09-14T21:31:51.850Z","Included","auto","No","1641","0","185959","293","187893","0.05"
"2025-09-14T21:29:59.419Z","Included","auto","No","1310","0","183608","292","185210","0.05"
"2025-09-14T21:28:59.799Z","Included","auto","No","696","0","90612","282","91590","0.02"
"2025-09-14T21:27:56.569Z","Included","auto","No","83888","0","97656","277","181821","0.11"
"2025-09-14T21:13:16.076Z","Included","auto","No","82762","0","94537","756","178055","0.11"
"2025-09-14T20:59:30.884Z","Included","auto","No","79961","0","7060","328","87349","0.08"
"2025-09-14T20:44:44.727Z","Errored, Not Charged","auto","No","3002","0","577413","2166","582581","0.16"
"2025-09-14T20:42:48.550Z","Included","auto","No","1072","0","141443","297","142812","0.04"
"2025-09-14T20:41:27.093Z","Included","auto","No","1965","0","278763","646","281374","0.07"
"2025-09-14T20:38:35.716Z","Included","auto","No","2405","0","201654","610","204669","0.06"
"2025-09-14T20:36:22.640Z","Included","auto","No","5706","0","373092","3384","382182","0.11"
"2025-09-14T20:31:23.039Z","Included","auto","No","2510","0","296830","1246","300586","0.08"
"2025-09-14T20:28:56.859Z","Included","auto","No","1250","0","172032","539","173821","0.05"
"2025-09-14T20:28:02.500Z","Included","auto","No","2549","0","164964","1030","168543","0.05"
"2025-09-14T20:27:41.809Z","Included","auto","No","2112","0","52299","352","54763","0.02"
"2025-09-14T20:25:45.015Z","Included","auto","No","10963","0","176230","495","187688","0.06"
"2025-09-14T20:22:35.763Z","Included","auto","No","1070","0","122045","353","123468","0.03"
"2025-09-14T20:21:21.530Z","Included","auto","No","11641","0","509928","1835","523404","0.15"
"2025-09-14T20:16:54.351Z","Included","auto","No","11601","0","368133","1183","380917","0.11"
"2025-09-14T20:11:40.370Z","Included","auto","No","9196","93236","7865","9445","119742","0.06"
"2025-09-14T20:10:47.038Z","Included","auto","No","1109","0","106846","367","108322","0.03"
"2025-09-14T20:08:50.775Z","Included","auto","No","99787","0","7060","1013","107860","0.11"
"2025-09-14T19:58:28.048Z","Included","auto","No","3735","0","403456","1573","408764","0.11"
"2025-09-14T19:53:44.340Z","Included","auto","No","92435","0","1355486","1534","1449455","0.44"
"2025-09-14T19:48:39.711Z","Included","auto","No","2419","0","633545","956","636920","0.16"
"2025-09-14T19:46:39.873Z","Included","auto","No","9647","0","1205136","1506","1216289","0.32"
"2025-09-14T19:45:20.274Z","Included","auto","No","503","0","78826","421","79750","0.02"
"2025-09-14T19:44:37.658Z","Included","auto","No","72107","0","396072","1517","469696","0.18"
"2025-09-14T19:43:19.313Z","Included","auto","No","2976","0","1054067","1269","1058312","0.27"
"2025-09-14T19:42:18.674Z","Included","auto","No","66969","0","664225","797","731991","0.24"
"2025-09-14T19:17:02.520Z","Errored, Not Charged","auto","No","20541","0","1157740","4817","1183098","0.33"
"2025-09-14T19:15:16.323Z","Included","auto","No","22218","0","665439","5622","693279","0.21"
"2025-09-14T19:14:26.656Z","Included","auto","No","16158","0","537603","1375","555136","0.16"
"2025-09-14T19:12:36.265Z","Included","auto","No","22038","0","7060","531","29629","0.03"
"2025-09-14T19:11:23.944Z","Included","auto","No","5290","1228","469146","2194","477858","0.14"
"2025-09-14T19:10:15.284Z","Included","auto","No","3418","0","122515","677","126610","0.04"
"2025-09-14T19:09:46.443Z","Included","auto","No","9708","0","22860","375","32943","0.02"
"2025-09-14T19:00:29.959Z","Included","auto","No","8581","0","88800","2373","99754","0.04"
"2025-09-14T18:57:15.244Z","Errored, Not Charged","auto","No","21353","0","319947","767","342067","0.10"
"2025-09-13T01:08:50.153Z","Included","auto","No","24217","0","1000110","1106","1025433","0.28"
"2025-09-13T01:08:18.102Z","Included","auto","No","1659","0","260651","342","262652","0.07"
"2025-09-13T00:47:23.993Z","Included","auto","No","2417","0","253295","994","256706","0.07"
"2025-09-13T00:23:02.944Z","Included","auto","No","49981","26275","2802010","8326","2886592","0.79"
"2025-09-13T00:22:41.235Z","Included","auto","No","25474","0","246044","853","272371","0.09"
"2025-09-13T00:21:06.572Z","Errored, Not Charged","auto","No","0","100523","0","7","100530","0.02"
"2025-09-13T00:10:36.816Z","Included","auto","No","12473","91430","2389951","4955","2498809","0.64"
"2025-09-13T00:07:00.782Z","Included","auto","No","108763","75375","698666","3967","886771","0.31"
"2025-09-13T00:01:01.400Z","Included","auto","No","93872","147796","2093579","16650","2351897","0.70"
"2025-09-12T23:58:40.624Z","Included","auto","No","7634","69198","609232","3899","689963","0.19"
"2025-09-12T23:55:36.099Z","Included","auto","No","5164","65231","489378","2205","561978","0.15"
"2025-09-12T23:52:32.863Z","Included","auto","No","2970","62467","309296","933","375666","0.09"
"2025-09-12T23:50:52.998Z","Included","auto","No","1549","65097","300766","1376","368788","0.11"
"2025-09-12T23:50:09.934Z","Errored, Not Charged","auto","No","807","60191","297250","357","358605","0.09"
"2025-09-12T23:46:55.308Z","Included","auto","No","15943","53893","762097","8190","840123","0.28"
"2025-09-12T23:42:47.658Z","Included","auto","No","9534","39759","417196","3280","469769","0.13"
"2025-09-12T23:37:26.850Z","Included","auto","No","8471","33364","264682","3128","309645","0.09"
"2025-09-12T23:30:46.586Z","Included","auto","No","41998","96606","344455","9381","492440","0.18"
"2025-09-12T23:18:38.446Z","Included","auto","No","3466","0","541252","759","545477","0.14"
"2025-09-12T23:14:42.409Z","Included","auto","No","2734","0","949554","860","953148","0.24"
"2025-09-12T23:11:57.338Z","Included","auto","No","6997","0","1320072","1053","1328122","0.34"
"2025-09-12T23:10:39.516Z","Included","auto","No","2612","0","780539","608","783759","0.20"
"2025-09-12T23:08:33.424Z","Included","auto","No","99929","0","2358277","3969","2462175","0.71"
"2025-09-12T23:06:29.873Z","Included","auto","No","6105","0","1213809","1340","1221254","0.31"
"2025-09-12T23:04:57.861Z","Included","auto","No","2602","0","695171","767","698540","0.18"
"2025-09-12T23:03:25.321Z","Included","auto","No","10199","17137","515297","2010","544643","0.15"
"2025-09-12T22:53:47.610Z","Included","auto","No","12234","0","53555","730","66519","0.03"
"2025-09-12T22:36:21.731Z","Included","auto","No","253179","207377","6910321","39766","7410643","2.20"
"2025-09-12T22:27:36.626Z","Errored, Not Charged","auto","No","117310","191607","5667008","25341","6001266","1.68"
"2025-09-12T22:22:09.710Z","Errored, Not Charged","auto","No","18231","53461","1504750","3855","1580297","0.42"
"2025-09-12T22:12:30.227Z","Errored, Not Charged","auto","No","84266","213823","3057434","14968","3370491","0.94"
"2025-09-12T22:10:11.336Z","Errored, Not Charged","auto","No","78247","63037","579819","3424","724527","0.25"
"2025-09-12T21:58:00.824Z","Errored, Not Charged","auto","No","6842","57131","663481","2615","730069","0.19"
"2025-09-12T21:57:02.407Z","Errored, Not Charged","auto","No","1217","56133","559122","700","617172","0.15"
"2025-09-12T21:53:39.417Z","Errored, Not Charged","auto","No","6701","49621","851780","1974","910076","0.23"
"2025-09-12T21:46:50.407Z","Errored, Not Charged","auto","No","5901","43440","767673","1132","818146","0.21"
"2025-09-12T21:38:05.552Z","Errored, Not Charged","auto","No","4487","39409","431389","1367","476652","0.12"
"2025-09-12T21:28:01.152Z","Included","auto","No","13670","29558","782455","16071","841754","0.28"
"2025-09-12T21:27:40.055Z","Included","auto","No","1609","28952","36719","494","67774","0.02"
"2025-09-12T21:19:11.388Z","Included","auto","No","439","27349","36281","359","64428","0.02"
"2025-09-12T21:14:22.981Z","Included","auto","No","5253","22414","335032","1098","363797","0.10"
"2025-09-12T21:05:24.361Z","Included","auto","No","44201","164796","343895","10122","563014","0.19"
"2025-09-12T21:02:47.019Z","Included","auto","No","5934","80410","1079142","1043","1166529","0.29"
"2025-09-12T20:58:18.642Z","Included","auto","No","3590","75604","1332285","1169","1412648","0.35"
"2025-09-12T20:55:45.060Z","Included","auto","No","7885","68062","3195268","1980","3273195","0.82"
"2025-09-12T20:52:58.141Z","Included","auto","No","18547","62471","2295457","2993","2379468","0.61"
"2025-09-12T20:47:07.073Z","Included","auto","No","23899","0","1381424","6581","1411904","0.40"
"2025-09-12T20:42:48.019Z","Included","auto","No","86685","55617","2121800","10086","2274188","0.66"
"2025-09-12T20:36:42.777Z","Included","auto","No","25261","0","3177694","12817","3215772","0.87"
"2025-09-12T20:34:30.959Z","Included","auto","No","5045","0","72626","810","78481","0.03"
"2025-09-12T20:28:03.932Z","Included","auto","No","62643","75749","1446948","20372","1605712","0.51"
"2025-09-12T20:17:15.014Z","Included","auto","No","14856","0","1226921","6354","1248131","0.35"
"2025-09-12T20:15:26.565Z","Included","auto","No","2560","3594","409528","2361","418043","0.13"
"2025-09-12T20:08:40.067Z","Included","auto","No","94302","0","307433","1028","402763","0.18"
"2025-09-12T19:48:59.152Z","Included","auto","No","12024","0","808136","5526","825686","0.24"
"2025-09-12T19:46:14.398Z","Included","auto","No","489","0","84297","479","85265","0.02"
"2025-09-12T19:33:07.052Z","Included","auto","No","9731","0","628714","4122","642567","0.18"
"2025-09-12T19:31:15.556Z","Included","auto","No","1152","0","73423","463","75038","0.02"
"2025-09-12T19:13:16.896Z","Included","auto","No","2239","0","215511","869","218619","0.06"
"2025-09-12T19:01:23.960Z","Included","auto","No","3009","0","277242","1283","281534","0.08"
"2025-09-12T18:53:16.556Z","Included","auto","No","61072","0","141492","1388","203952","0.10"
"2025-09-12T07:13:54.701Z","Included","auto","No","61630","156204","663104","10020","890958","0.29"
"2025-09-12T07:04:18.489Z","Included","auto","No","19785","0","1661068","3929","1684782","0.45"
"2025-09-12T06:55:15.522Z","Included","auto","No","11215","0","1450643","2604","1464462","0.38"
"2025-09-12T06:54:36.941Z","Included","auto","No","586","0","77099","269","77954","0.02"
"2025-09-12T06:46:10.866Z","Included","auto","No","6523","0","214382","1894","222799","0.07"
"2025-09-12T06:41:59.437Z","Included","auto","No","25857","0","1926334","8157","1960348","0.54"
"2025-09-12T06:40:46.317Z","Included","auto","No","607","0","44153","318","45078","0.01"
"2025-09-12T06:36:35.631Z","Included","auto","No","468","0","43686","324","44478","0.01"
"2025-09-12T06:36:02.051Z","Included","auto","No","1091","0","42596","317","44004","0.01"
"2025-09-12T06:30:53.150Z","Included","auto","No","4758","0","282776","925","288459","0.08"
"2025-09-12T06:25:27.244Z","Included","auto","No","4010","0","216031","608","220649","0.06"
"2025-09-12T06:20:00.774Z","Included","auto","No","26728","0","342650","2414","371792","0.12"
"2025-09-12T05:50:58.705Z","Included","auto","No","477","0","27350","230","28057","0.01"
"2025-09-12T05:47:49.906Z","Errored, Not Charged","auto","No","31755","0","122142","2072","155969","0.07"
"2025-09-12T05:45:18.534Z","Included","auto","No","5748","0","557092","2360","565200","0.15"
"2025-09-12T05:37:56.373Z","Included","auto","No","3633","0","745112","1052","749797","0.19"
"2025-09-12T05:33:44.841Z","Included","auto","No","5696","0","813676","1716","821088","0.22"
"2025-09-12T05:33:08.163Z","Included","auto","No","1172","0","98373","255","99800","0.03"
"2025-09-12T05:24:08.173Z","Included","auto","No","7347","0","473851","3381","484579","0.14"
"2025-09-12T05:23:02.337Z","Included","auto","No","492","0","90540","335","91367","0.02"
"2025-09-12T05:22:09.128Z","Included","auto","No","965","0","89576","336","90877","0.02"
"2025-09-12T05:16:02.933Z","Included","auto","No","2796","0","439961","879","443636","0.12"
"2025-09-12T05:14:07.958Z","Included","auto","No","2992","0","425399","943","429334","0.11"
"2025-09-12T05:13:20.470Z","Included","auto","No","3449","0","490796","1296","495541","0.13"
"2025-09-12T05:12:51.992Z","Included","auto","No","416","0","79940","260","80616","0.02"
"2025-09-12T05:12:13.081Z","Included","auto","No","537","0","79404","259","80200","0.02"
"2025-09-12T05:11:42.782Z","Included","auto","No","1354","0","78051","383","79788","0.02"
"2025-09-12T05:09:41.278Z","Included","auto","No","689","0","77363","332","78384","0.02"
"2025-09-12T05:06:55.340Z","Included","auto","No","568","0","76796","249","77613","0.02"
"2025-09-12T05:05:01.739Z","Included","auto","No","6363","0","588450","2437","597250","0.16"
"2025-09-12T05:03:18.135Z","Included","auto","No","63334","0","349197","2463","414994","0.16"
"2025-09-12T03:04:13.719Z","Included","auto","No","11029","0","578251","7950","597230","0.19"
"2025-09-12T03:03:11.939Z","Included","auto","No","557","0","51875","313","52745","0.01"
"2025-09-12T03:00:54.476Z","Included","auto","No","6719","0","478789","2747","488255","0.14"
"2025-09-12T02:59:03.301Z","Included","auto","No","5074","0","546845","901","552820","0.15"
"2025-09-12T02:58:11.691Z","Included","auto","No","1886","0","156625","1031","159542","0.05"
"2025-09-12T02:57:09.477Z","Included","auto","No","4695","0","283761","4075","292531","0.09"
"2025-09-12T02:51:40.001Z","Included","auto","No","1527","16961","32010","1141","51639","0.02"
"2025-09-12T02:50:06.844Z","Included","auto","No","414","0","31597","295","32306","0.01"
"2025-09-12T02:47:56.999Z","Errored, Not Charged","auto","No","21087","0","10511","314","31912","0.02"
"2025-09-12T02:46:51.337Z","Included","auto","No","8807","0","896530","793","906130","0.24"
"2025-09-12T02:45:46.485Z","Included","auto","No","387","0","108371","229","108987","0.03"
"2025-09-12T02:45:16.939Z","Included","auto","No","481","0","107891","274","108646","0.03"
"2025-09-12T02:44:39.454Z","Included","auto","No","443","0","107449","317","108209","0.03"
"2025-09-12T02:43:59.734Z","Included","auto","No","452","0","106998","279","107729","0.03"
"2025-09-12T02:41:54.468Z","Included","auto","No","467","0","106532","305","107304","0.03"
"2025-09-12T02:41:01.081Z","Included","auto","No","379","0","106154","301","106834","0.03"
"2025-09-12T02:40:20.834Z","Included","auto","No","443","0","105712","230","106385","0.03"
"2025-09-12T02:38:37.912Z","Included","auto","No","1617","5778","313641","1526","322562","0.11"
"2025-09-12T02:35:21.405Z","Included","auto","No","411","0","103688","191","104290","0.03"
"2025-09-12T02:34:48.642Z","Included","auto","No","442","0","103247","269","103958","0.03"
"2025-09-12T02:32:52.400Z","Included","auto","No","444","0","102804","296","103544","0.03"
"2025-09-12T02:29:28.101Z","Included","auto","No","535","0","102270","292","103097","0.03"
"2025-09-12T02:29:02.321Z","Included","auto","No","414","0","101857","386","102657","0.03"
"2025-09-12T02:20:49.430Z","Included","auto","No","94745","0","7113","273","102131","0.10"
"2025-09-12T01:43:37.886Z","Included","auto","No","4730","0","193684","4624","203038","0.07"
"2025-09-12T01:36:09.264Z","Included","auto","No","13234","0","1156807","8580","1178621","0.34"
"2025-09-12T01:33:35.865Z","Included","auto","No","14195","0","1515521","6422","1536138","0.42"
"2025-09-12T01:33:00.886Z","Included","auto","No","1490","0","204429","393","206312","0.05"
"2025-09-12T01:32:33.044Z","Included","auto","No","6935","0","573775","635","581345","0.15"
"2025-09-12T01:28:08.553Z","Included","auto","No","6187","0","400678","1095","407960","0.11"
"2025-09-12T01:25:24.089Z","Included","auto","No","5929","0","201564","2674","210167","0.07"
"2025-09-12T01:24:28.560Z","Included","auto","No","438","0","48368","190","48996","0.01"
"2025-09-12T01:24:10.118Z","Included","auto","No","343","0","48026","271","48640","0.01"
"2025-09-12T01:20:09.552Z","Included","auto","No","908","0","94707","333","95948","0.03"
"2025-09-12T01:18:22.422Z","Included","auto","No","40023","0","667534","2124","709681","0.22"
"2025-09-12T01:17:12.199Z","Included","auto","No","2725","0","275073","852","278650","0.07"
"2025-09-12T01:16:55.928Z","Included","auto","No","1012","0","112742","340","114094","0.03"
"2025-09-12T01:12:31.644Z","Included","auto","No","2461","0","250111","580","253152","0.07"
"2025-09-12T01:12:08.687Z","Included","auto","No","27310","0","7421","297","35028","0.03"
"2025-09-12T01:08:44.678Z","Included","auto","No","24375","896862","9839","8961","940037","0.19"
"2025-09-12T01:06:48.339Z","Included","auto","No","1040","896373","100737","7407","1005557","0.19"
"2025-09-12T01:05:14.637Z","Included","auto","No","435","897226","100303","3848","1001812","0.17"
"2025-09-12T01:04:22.123Z","Included","auto","No","436","897123","99868","14569","1011996","0.21"
"2025-09-12T01:03:47.647Z","Included","auto","No","463","896997","99406","4008","1000874","0.17"
"2025-09-12T01:03:15.260Z","Included","auto","No","414","896680","98993","14603","1010690","0.21"
"2025-09-12T00:56:42.507Z","Included","auto","No","6291","0","856184","1956","864431","0.23"
"2025-09-12T00:55:55.061Z","Included","auto","No","5584","0","896302","728","902614","0.23"
"2025-09-12T00:55:37.122Z","Included","auto","No","384","0","86754","226","87364","0.02"
"2025-09-12T00:55:04.471Z","Included","auto","No","480","0","86275","200","86955","0.02"
"2025-09-12T00:54:13.472Z","Included","auto","No","4455","0","419739","526","424720","0.11"
"2025-09-12T00:53:44.093Z","Included","auto","No","42997","0","38829","308","82134","0.05"
"2025-09-12T00:53:13.639Z","Included","auto","No","9241","0","35724","339","45304","0.02"
"2025-09-12T00:51:59.957Z","Included","auto","No","4044","0","231714","655","236413","0.06"
"2025-09-12T00:51:02.683Z","Included","auto","No","3113","0","149859","444","153416","0.04"
"2025-09-12T00:50:21.588Z","Included","auto","No","370","0","28210","181","28761","0.01"
"2025-09-12T00:46:25.229Z","Included","auto","No","298","0","27913","192","28403","0.01"
"2025-09-12T00:46:03.411Z","Included","auto","No","439","0","27475","132","28046","0.01"
"2025-09-12T00:45:39.529Z","Included","auto","No","395","0","27081","274","27750","0.01"
"2025-09-12T00:45:17.292Z","Included","auto","No","349","0","26733","225","27307","0.01"
"2025-09-12T00:44:45.824Z","Included","auto","No","16921","0","56746","297","73964","0.03"
"2025-09-12T00:38:26.247Z","Included","auto","No","4954","467469","566163","11749","1050335","0.26"
"2025-09-12T00:35:41.471Z","Included","auto","No","2565","920242","325057","19207","1267071","0.29"
"2025-09-12T00:34:50.077Z","Included","auto","No","334","459390","107736","9836","577296","0.13"
"2025-09-12T00:34:20.402Z","Included","auto","No","257","457853","107480","14034","579624","0.15"
"2025-09-12T00:33:24.472Z","Included","auto","No","1591","915662","425637","14390","1357280","0.30"
"2025-09-12T00:31:56.432Z","Included","auto","No","273","457207","105621","10434","573535","0.13"
"2025-09-12T00:31:32.588Z","Included","auto","No","160","3092","558773","6572","568597","0.07"
"2025-09-12T00:28:25.640Z","Included","auto","No","1052","910696","524535","22663","1458946","0.35"
"2025-09-12T00:28:01.014Z","Included","auto","No","2465","909145","308120","24370","1244100","0.30"
"2025-09-12T00:26:40.322Z","Included","auto","No","317","447883","101637","7986","557823","0.12"
"2025-09-12T00:25:35.968Z","Included","auto","No","5609","898697","689416","15292","1609014","0.37"
"2025-09-12T00:23:48.698Z","Included","auto","No","1029","0","190274","169","191472","0.05"
"2025-09-12T00:23:30.283Z","Included","auto","No","372","0","94637","119","95128","0.02"
"2025-09-12T00:23:03.064Z","Included","auto","No","381","0","94257","233","94871","0.02"
"2025-09-12T00:22:30.879Z","Included","auto","No","382","0","93876","225","94483","0.02"
"2025-09-12T00:22:08.349Z","Included","auto","No","409","0","93468","237","94114","0.02"
"2025-09-12T00:21:17.128Z","Included","auto","No","492","0","92977","256","93725","0.02"
"2025-09-12T00:20:31.489Z","Included","auto","No","4415","0","88563","327","93305","0.03"
"2025-09-12T00:18:07.430Z","Included","auto","No","81454","4383","270750","1243","357830","0.17"
"2025-09-12T00:15:13.517Z","Included","auto","No","3255","0","252215","448","255918","0.07"
"2025-09-12T00:12:12.049Z","Included","auto","No","4920","0","487819","502","493241","0.13"
"2025-09-12T00:11:02.225Z","Included","auto","No","431","0","78379","469","79279","0.02"
"2025-09-12T00:10:25.245Z","Included","auto","No","636","0","77744","289","78669","0.02"
"2025-09-12T00:10:00.102Z","Included","auto","No","653","0","77092","490","78235","0.02"
"2025-09-12T00:06:44.847Z","Included","auto","No","129317","143870","243499","7513","524199","0.24"
"2025-09-12T00:03:07.712Z","Included","auto","No","2792","0","261108","1789","265689","0.08"
"2025-09-11T23:56:43.150Z","Included","auto","No","4069","0","500901","625","505595","0.13"
"2025-09-11T23:54:34.951Z","Included","auto","No","3236","0","399980","1667","404883","0.11"
"2025-09-11T23:53:39.346Z","Included","auto","No","762","0","78232","316","79310","0.02"
"2025-09-11T23:50:54.584Z","Included","auto","No","12467","0","563061","872","576400","0.16"
"2025-09-11T23:47:17.294Z","Included","auto","No","66247","1138625","777017","16340","1998229","0.49"
"2025-09-11T23:46:20.861Z","Included","auto","No","434","557593","105443","10929","674399","0.15"
"2025-09-11T23:44:58.055Z","Included","auto","No","756","58090","104688","7487","171021","0.06"
"2025-09-11T23:44:24.987Z","Included","auto","No","11685","0","93004","619","105308","0.04"
"2025-09-11T23:41:17.703Z","Included","auto","No","6524","57429","3941606","8128","4013687","1.03"
"2025-09-11T23:34:20.092Z","Included","auto","No","3213","0","443405","2171","448789","0.12"
"2025-09-11T23:20:47.255Z","Included","auto","No","4603","0","338237","4087","346927","0.11"
"2025-09-11T23:19:52.144Z","Included","auto","No","1099","0","246169","443","247711","0.06"
"2025-09-11T23:16:35.151Z","Included","auto","No","74658","0","165570","2537","242765","0.13"
"2025-09-11T23:10:42.916Z","Included","auto","No","2377","0","230745","878","234000","0.06"
"2025-09-11T23:09:50.282Z","Included","auto","No","6157","0","431634","4230","442021","0.13"
"2025-09-11T22:35:27.848Z","Errored, Not Charged","auto","No","16413","0","719920","7489","743822","0.23"
"2025-09-11T22:31:39.406Z","Included","auto","No","3242","0","101247","496","104985","0.03"
"2025-09-11T22:27:48.476Z","Included","auto","No","4954","0","141027","4652","150633","0.06"
"2025-09-11T22:24:26.926Z","Included","auto","No","9419","0","282520","2576","294515","0.09"
"2025-09-11T22:16:39.626Z","Included","auto","No","40544","79947","283961","15179","419631","0.18"
"2025-09-11T22:14:52.655Z","Included","auto","No","6185","19138","860181","6651","892155","0.33"
"2025-09-11T22:03:33.279Z","Included","auto","No","115338","5118","1542636","11702","1674794","0.57"
"2025-09-11T21:59:59.033Z","Included","auto","No","18089","0","953791","7238","979118","0.29"
"2025-09-11T21:50:40.263Z","Included","auto","No","42607","0","143097","467","186171","0.08"
"2025-09-11T21:45:05.722Z","Included","auto","No","9671","0","479685","1838","491194","0.14"
"2025-09-11T21:44:47.902Z","Included","auto","No","318","0","49507","206","50031","0.01"
"2025-09-11T21:42:47.920Z","Included","auto","No","4082","0","577249","1018","582349","0.15"
"2025-09-11T21:31:20.076Z","Included","auto","No","1462","0","87566","1240","90268","0.03"
"2025-09-11T21:30:55.288Z","Included","auto","No","134","0","43526","146","43806","0.01"
"2025-09-11T21:29:57.871Z","Included","auto","No","1198","0","214434","330","215962","0.06"
"2025-09-11T21:29:33.897Z","Included","auto","No","6200","0","36134","163","42497","0.02"
"2025-09-11T21:28:28.317Z","Included","auto","No","1871","0","140051","282","142204","0.04"
"2025-09-11T21:28:13.362Z","Included","auto","No","341","0","33927","113","34381","0.01"
"2025-09-11T21:27:30.044Z","Included","auto","No","2783","0","223264","645","226692","0.06"
"2025-09-11T21:26:23.016Z","Included","auto","No","2503","0","237480","415","240398","0.06"
"2025-09-11T21:25:57.749Z","Included","auto","No","254","0","28590","70","28914","0.01"
"2025-09-11T21:24:58.324Z","Included","auto","No","1594","0","137618","322","139534","0.04"
"2025-09-11T21:23:46.280Z","Included","auto","No","1560","0","183628","481","185669","0.05"
"2025-09-11T21:23:00.855Z","Included","auto","No","3776","0","283562","795","288133","0.08"
"2025-09-11T21:21:02.309Z","Included","auto","No","13702","100039","7983","11814","133538","0.07"
"2025-09-11T21:20:17.432Z","Errored, Not Charged","auto","No","1525","0","222930","227","224682","0.06"
"2025-09-11T21:19:12.020Z","Included","auto","No","1927","0","427817","581","430325","0.11"
"2025-09-11T21:18:33.082Z","Included","auto","No","1315","0","122585","364","124264","0.03"
"2025-09-11T21:16:04.408Z","Included","auto","No","9689","0","954284","3090","967063","0.26"
"2025-09-11T21:14:14.990Z","Included","auto","No","2883","0","410894","1038","414815","0.11"
"2025-09-11T21:13:27.899Z","Included","auto","No","4644","0","286681","1731","293056","0.08"
"2025-09-11T21:11:25.670Z","Included","auto","No","2523","0","329901","734","333158","0.09"
"2025-09-11T21:10:47.980Z","Included","auto","No","7568","0","170250","738","178556","0.05"
"2025-09-11T21:09:26.387Z","Included","auto","No","11180","0","88087","742","100009","0.04"
"2025-09-11T21:08:30.977Z","Errored, Not Charged","auto","No","0","0","0","0","0","0.00"
"2025-09-11T21:07:47.146Z","Included","auto","No","1100","0","107576","231","108907","0.03"
"2025-09-11T21:06:44.150Z","Included","auto","No","21343","0","86234","258","107835","0.04"
"2025-09-11T21:05:25.931Z","Included","auto","No","2885","0","676429","613","679927","0.17"
"2025-09-11T21:03:55.277Z","Included","auto","No","1935","0","741969","748","744652","0.19"
"2025-09-11T21:03:06.281Z","Included","auto","No","1133","0","160912","352","162397","0.04"
"2025-09-11T21:01:32.769Z","Included","auto","No","2744","0","789655","1106","793505","0.20"
"2025-09-11T21:00:00.219Z","Included","auto","No","2226","0","764654","613","767493","0.20"
"2025-09-11T20:57:02.222Z","Included","auto","No","22940","0","184280","585","207805","0.07"
"2025-09-11T20:54:34.705Z","Included","auto","No","13479","0","1162441","1333","1177253","0.31"
"2025-09-11T20:51:23.308Z","Included","auto","No","7541","0","951425","2558","961524","0.26"
"2025-09-11T20:42:01.077Z","Included","auto","No","34650","80884","1010080","10297","1135911","0.34"
"2025-09-11T20:31:45.639Z","Included","auto","No","19463","0","2174562","6183","2200208","0.59"
"2025-09-11T20:10:23.132Z","Included","auto","No","18403","0","3657509","4023","3679935","0.95"
"2025-09-11T20:04:42.411Z","Included","auto","No","66832","0","142900","1679","211411","0.11"
"2025-09-11T20:02:56.654Z","Included","auto","No","584","0","67057","381","68022","0.02"
"2025-09-11T20:01:33.060Z","Included","auto","No","685","0","66373","446","67504","0.02"
"2025-09-11T20:00:16.122Z","Included","auto","No","841","0","65533","548","66922","0.02"
"2025-09-11T19:43:36.470Z","Included","auto","No","4396","0","308187","1432","314015","0.09"
"2025-09-11T19:42:58.569Z","Errored, Not Charged","auto","No","825","0","120506","158","121489","0.03"
"2025-09-11T19:22:13.232Z","Included","auto","No","3959","0","286217","1570","291746","0.08"
"2025-09-11T19:20:06.351Z","Included","auto","No","3560","2642","321745","2922","330869","0.11"
"2025-09-11T19:13:45.441Z","Included","auto","No","35604","0","236643","1087","273334","0.10"
"2025-09-11T19:12:15.238Z","Included","auto","No","2101","0","128183","804","131088","0.04"
"2025-09-11T19:11:44.882Z","Included","auto","No","4991","0","9799","606","15396","0.01"
"2025-09-11T19:09:19.430Z","Included","auto","No","4802","166277","7944","5225","184248","0.05"
"2025-09-11T19:08:21.234Z","Included","auto","No","6316","0","90353","795","97464","0.03"
"2025-09-11T05:07:02.048Z","Included","auto","No","5292","7206","173082","3741","189321","0.03"
"2025-09-11T05:04:13.637Z","Included","auto","No","13179","172008","118013","3702","306902","0.08"
"2025-09-11T04:59:12.646Z","Errored, Not Charged","auto","No","8544","9703","13590","1022","32859","0.02"
"2025-09-11T04:57:41.888Z","Included","auto","No","2232","9426","17940","1088","30686","0.01"
"2025-09-11T04:56:50.841Z","Included","auto","No","4267","10008","57009","2604","73888","0.03"
"2025-09-11T04:54:57.511Z","Included","auto","No","9223","16960","58382","2469","87034","0.04"
"2025-09-11T04:52:31.872Z","Included","auto","No","8062","169324","7142","5706","190234","0.06"
"2025-09-11T04:44:57.180Z","Included","auto","No","8502","7548","37522","1189","54761","0.02"
"2025-09-11T04:44:29.743Z","Included","auto","No","1130","0","12746","209","14085","0.01"
"2025-09-11T04:43:24.456Z","Included","auto","No","10328","167226","42172","4363","224089","0.06"
"2025-09-11T04:31:11.083Z","Included","auto","No","551","0","89710","318","90579","0.02"
"2025-09-11T04:27:57.887Z","Included","auto","No","11341","0","570163","2799","584303","0.17"
"2025-09-11T04:26:37.838Z","Included","auto","No","818","0","77559","270","78647","0.02"
"2025-09-11T04:25:23.589Z","Included","auto","No","259","0","77301","220","77780","0.02"
"2025-09-11T04:24:58.237Z","Included","auto","No","511","0","76791","138","77440","0.02"
"2025-09-11T04:22:07.299Z","Included","auto","No","536","0","76256","411","77203","0.02"
"2025-09-11T04:07:51.530Z","Included","auto","No","1409","0","74848","364","76621","0.02"
"2025-09-11T04:04:48.681Z","Included","auto","No","442","0","74407","299","75148","0.02"
"2025-09-11T04:01:32.374Z","Included","auto","No","3643","0","70765","346","74754","0.02"
"2025-09-11T04:00:04.081Z","Included","auto","No","2246","56864","70453","2125","131688","0.04"
"2025-09-11T03:59:10.474Z","Included","auto","No","967","0","69487","270","70724","0.02"
"2025-09-11T03:50:15.770Z","Included","auto","No","29357","0","856740","13789","899886","0.30"
"2025-09-11T03:49:44.297Z","Included","auto","No","684","0","79243","370","80297","0.02"
"2025-09-11T03:45:40.914Z","Included","auto","No","1101","0","155294","511","156906","0.04"
"2025-09-11T03:45:08.512Z","Included","auto","No","31308","0","44033","294","75635","0.04"
"2025-09-11T02:42:53.397Z","Included","auto","No","242","0","36325","294","36861","0.01"
"2025-09-11T02:41:55.642Z","Included","auto","No","982","20272","35344","891","57489","0.02"
"2025-09-11T02:41:27.782Z","Included","auto","No","254","0","35091","137","35482","0.01"
"2025-09-11T02:41:09.017Z","Included","auto","No","241","0","34851","155","35247","0.01"
"2025-09-11T02:39:31.122Z","Included","auto","No","3943","18542","299249","1549","323283","0.09"
"2025-09-11T02:38:12.705Z","Included","auto","No","2402","0","264313","825","267540","0.07"
"2025-09-11T02:37:50.809Z","Errored, Not Charged","auto","No","323","0","56293","137","56753","0.01"
"2025-09-11T02:36:37.205Z","Included","auto","No","3420","0","212131","696","216247","0.06"
"2025-09-11T02:34:17.472Z","Included","auto","No","1344","0","167797","521","169662","0.05"
"2025-09-11T02:34:03.619Z","Included","auto","No","491","0","45879","156","46526","0.01"
"2025-09-11T02:27:08.681Z","Included","auto","No","1260","0","154716","567","156543","0.04"
"2025-09-11T02:24:31.704Z","Included","auto","No","3715","12802","239454","1733","257704","0.07"
"2025-09-11T02:23:31.583Z","Included","auto","No","613","0","52663","173","53449","0.01"
"2025-09-11T02:23:10.418Z","Included","auto","No","18603","0","16105","195","34903","0.02"
"2025-09-11T02:22:29.954Z","Included","auto","No","518","0","328899","226","329643","0.08"
"2025-09-11T02:21:30.397Z","Included","auto","No","1597","0","977027","521","979145","0.25"
"2025-09-11T02:20:50.256Z","Included","auto","No","396","0","215265","355","216016","0.06"
"2025-09-11T02:11:12.428Z","Included","auto","No","100529","0","4987684","4400","5092613","1.37"
"2025-09-11T02:10:36.297Z","Included","auto","No","2500","0","51958","364","54822","0.02"
"2025-09-11T02:09:51.561Z","Errored, Not Charged","auto","No","27343","0","7760","105","35208","0.03"
"2025-09-11T02:08:59.296Z","Included","auto","No","1032","0","7060","113","8205","0.003"
"2025-09-11T02:08:28.982Z","Errored, Not Charged","auto","No","0","0","0","0","0","0.00"
"2025-09-11T02:06:38.327Z","Errored, Not Charged","auto","No","0","0","0","0","0","0.00"
"2025-09-11T02:02:09.994Z","Included","auto","No","7921","0","2048248","1418","2057587","0.53"
"2025-09-11T02:00:00.932Z","Included","auto","No","9256","0","1430275","1939","1441470","0.37"
"2025-09-11T01:57:02.080Z","Included","auto","No","7195","0","809578","2283","819056","0.22"
"2025-09-11T01:56:00.597Z","Included","auto","No","6763","0","662713","1596","671072","0.18"
"2025-09-11T01:54:09.633Z","Included","auto","No","61817","0","613212","1753","676782","0.22"
"2025-09-11T01:50:45.519Z","Included","auto","No","11029","0","933592","2207","946828","0.25"
"2025-09-11T01:42:37.326Z","Included","auto","No","86949","76032","376839","16522","556342","0.25"
"2025-09-11T01:40:08.103Z","Included","auto","No","6666","0","901058","1588","909312","0.24"
"2025-09-11T01:36:52.082Z","Included","auto","No","2886","0","841700","1387","845973","0.22"
"2025-09-11T01:35:29.211Z","Errored, Not Charged","auto","No","7580","0","884092","1842","893514","0.24"
"2025-09-11T01:32:57.043Z","Included","auto","No","20051","0","1220518","2382","1242951","0.33"
"2025-09-11T01:29:25.694Z","Included","auto","No","6317","0","839115","3207","848639","0.23"
"2025-09-11T01:27:09.997Z","Included","auto","No","41597","0","1346776","4152","1392525","0.39"
"2025-09-11T01:19:34.679Z","Included","auto","No","26044","0","1749587","2552","1778183","0.47"
"2025-09-11T01:09:13.796Z","Included","auto","No","60632","88073","1748505","21117","1918327","0.59"
"2025-09-11T01:05:05.574Z","Included","auto","No","7951","0","1124233","660","1132844","0.29"
"2025-09-11T01:04:18.355Z","Included","auto","No","776","0","192071","393","193240","0.05"
"2025-09-11T01:00:39.874Z","Included","auto","No","8539","0","87274","296","96109","0.03"
"2025-09-11T01:00:15.361Z","Included","auto","No","2005","0","603458","1025","606488","0.16"
"2025-09-11T00:59:14.585Z","Included","auto","No","5301","0","334455","507","340263","0.09"
"2025-09-11T00:57:23.745Z","Included","auto","No","37642","0","865160","2455","905257","0.26"
"2025-09-11T00:54:48.202Z","Included","auto","No","1690","0","272808","747","275245","0.07"
"2025-09-11T00:54:24.431Z","Included","auto","No","1250","0","131934","683","133867","0.04"
"2025-09-11T00:53:48.284Z","Included","auto","No","2376","0","209785","815","212976","0.06"
"2025-09-11T00:53:16.727Z","Included","auto","No","820","0","81238","367","82425","0.02"
"2025-09-11T00:52:27.125Z","Included","auto","No","3127","0","426725","1250","431102","0.11"
"2025-09-11T00:51:13.168Z","Included","auto","No","11740","0","439521","2776","454037","0.13"
"2025-09-11T00:49:30.652Z","Included","auto","No","19958","90948","115870","14248","241024","0.11"
"2025-09-11T00:48:03.327Z","Included","auto","No","4033","0","4303935","1400","4309368","1.09"
"2025-09-11T00:47:43.836Z","Included","auto","No","471","0","107095","418","107984","0.03"
"2025-09-11T00:45:33.747Z","Included","auto","No","11355","0","1653334","4769","1669458","0.44"
"2025-09-11T00:42:06.900Z","Included","auto","No","21548","0","1462599","11937","1496084","0.43"
"2025-09-11T00:41:22.297Z","Included","auto","No","4806","0","69420","637","74863","0.02"
"2025-09-11T00:37:48.473Z","Included","auto","No","82023","59750","1477404","16719","1635896","0.52"
"2025-09-11T00:34:22.688Z","Included","auto","No","122883","11432","2588884","6495","2729694","1.25"
"2025-09-11T00:29:51.999Z","Included","auto","No","141654","56446","2153184","11289","2362573","0.73"
"2025-09-11T00:27:00.564Z","Included","auto","No","15138","2136","1851285","11953","1880512","0.54"
"2025-09-11T00:21:14.306Z","Included","auto","No","808","0","66217","403","67428","0.02"
"2025-09-11T00:15:31.088Z","Included","auto","No","11952","5568","962975","8327","988822","0.31"
"2025-09-11T00:09:12.883Z","Included","auto","No","47222","0","7060","583","54865","0.05"
"2025-09-10T23:01:33.676Z","Included","auto","No","12245","0","717721","1361","731327","0.20"
"2025-09-10T22:34:07.607Z","Included","auto","No","35159","0","170050","570","205779","0.08"
"2025-09-10T22:33:37.476Z","Included","auto","No","996","0","118586","189","119771","0.03"
"2025-09-10T22:32:36.153Z","Included","auto","No","31078","0","460626","1030","492734","0.15"
"2025-09-10T22:29:03.292Z","Included","auto","No","44237","0","1636841","2357","1683435","0.46"
"2025-09-10T22:28:31.348Z","Included","auto","No","809","0","207279","406","208494","0.05"
"2025-09-10T22:27:37.643Z","Included","auto","No","86627","0","119926","371","206924","0.12"
"2025-09-10T22:20:17.887Z","Included","auto","No","95149","0","1321232","2393","1418774","0.44"
"2025-09-10T22:18:52.596Z","Errored, Not Charged","auto","No","0","0","0","0","0","0.00"
"2025-09-10T22:16:25.146Z","Included","auto","No","6671","0","1406798","3345","1416814","0.37"
"2025-09-10T22:08:18.063Z","Included","auto","No","12594","0","1972202","7256","1992052","0.53"
"2025-09-10T22:06:18.749Z","Included","auto","No","32389","0","1079034","7373","1118796","0.33"
"2025-09-10T22:05:04.243Z","Included","auto","No","6012","0","1691232","1587","1698831","0.44"
"2025-09-10T22:03:19.845Z","Included","auto","No","5497","0","474500","2104","482101","0.13"
"2025-09-10T22:02:46.335Z","Included","auto","No","3593","0","380644","2090","386327","0.11"
"2025-09-10T22:01:10.443Z","Included","auto","No","55210","0","248029","1773","305012","0.12"
"2025-09-10T22:00:13.801Z","Included","auto","No","3784","0","397436","1050","402270","0.11"
"2025-09-10T21:59:37.556Z","Included","auto","No","452","0","55089","375","55916","0.02"
"2025-09-10T21:57:39.388Z","Included","auto","No","7167","0","357615","2578","367360","0.11"
"2025-09-10T21:55:28.590Z","Included","auto","No","9884","0","287769","8840","306493","0.12"
"2025-09-10T21:45:19.049Z","Included","auto","No","5699","0","98017","445","104161","0.03"
"2025-09-10T21:43:15.017Z","Included","auto","No","6657","0","710763","2299","719719","0.19"
"2025-09-10T21:36:54.248Z","Included","auto","No","35824","79072","42514","5261","162671","0.08"
"2025-09-10T21:34:56.289Z","Included","auto","No","11614","0","2764365","2222","2778201","0.71"
"2025-09-10T21:34:06.744Z","Included","auto","No","95747","0","687230","1136","784113","0.27"
"2025-09-10T21:25:04.169Z","Included","auto","No","1762","0","263080","782","265624","0.07"
"2025-09-10T21:24:18.545Z","Included","auto","No","3184","0","426226","1122","430532","0.11"
"2025-09-10T21:19:22.490Z","Included","auto","No","16664","0","589182","22920","628766","0.26"
"2025-09-10T21:18:47.948Z","Included","auto","No","3014","0","195442","1337","199793","0.06"
"2025-09-10T21:12:25.817Z","Included","auto","No","14236","0","203769","519","218524","0.07"
"2025-09-10T21:10:25.201Z","Included","auto","No","531","0","49376","282","50189","0.01"
"2025-09-10T21:07:18.910Z","Included","auto","No","5576","0","43801","347","49724","0.02"
"2025-09-10T21:02:44.836Z","Included","auto","No","8984","0","235409","8250","252643","0.10"
"2025-09-10T21:01:46.928Z","Included","auto","No","4930","5864","164557","2087","177438","0.08"
"2025-09-10T20:59:42.122Z","Included","auto","No","286","0","29613","115","30014","0.01"
"2025-09-10T20:58:42.538Z","Included","auto","No","311","0","29303","115","29729","0.01"
"2025-09-10T20:45:59.997Z","Included","auto","No","21798","0","65340","417","87555","0.04"
"2025-09-10T20:41:16.502Z","Included","auto","No","19622","66236","8838","8218","102914","0.06"
"2025-09-10T20:31:09.087Z","Included","auto","No","102181","0","435518","1909","539608","0.22"
"2025-09-10T19:35:30.974Z","Included","auto","No","6305","0","669768","1325","677398","0.18"
"2025-09-10T19:32:25.795Z","Included","auto","No","5571","0","356279","1027","362877","0.10"
"2025-09-10T19:30:56.976Z","Included","auto","No","4039","0","501696","1745","507480","0.14"
"2025-09-10T19:28:03.415Z","Included","auto","No","10639","0","994424","8645","1013708","0.29"
"2025-09-10T19:25:16.853Z","Included","auto","No","62365","0","8839","293","71497","0.07"
"2025-09-10T19:24:21.322Z","Included","auto","No","2277","0","1103271","954","1106502","0.28"
"2025-09-10T19:23:44.089Z","Included","auto","No","1555","0","909211","503","911269","0.23"
"2025-09-10T19:23:02.010Z","Included","auto","No","1788","0","324184","939","326911","0.09"
"2025-09-10T19:21:52.105Z","Included","auto","No","1172","0","318827","738","320737","0.08"
"2025-09-10T19:21:29.139Z","Included","auto","No","2286","0","232922","1113","236321","0.06"
"2025-09-10T19:16:09.249Z","Included","auto","No","5460","0","661881","3484","670825","0.18"
"2025-09-10T19:15:02.744Z","Included","auto","No","234","0","71278","157","71669","0.02"
"2025-09-10T19:07:30.284Z","Included","auto","No","666","0","141603","357","142626","0.04"
"2025-09-10T18:53:46.893Z","Included","auto","No","63559","0","286980","892","351431","0.14"
"2025-09-10T09:13:22.013Z","Included","auto","No","829","0","137268","476","138573","0.04"
"2025-09-10T09:12:44.680Z","Included","auto","No","1161","0","135044","922","137127","0.04"
"2025-09-10T09:11:15.966Z","Included","auto","No","707","0","200755","381","201843","0.05"
"2025-09-10T09:04:12.753Z","Included","auto","No","10939","0","234445","420","245804","0.07"
"2025-09-10T09:03:34.541Z","Included","auto","No","963","0","220457","777","222197","0.06"
"2025-09-10T09:01:44.583Z","Included","auto","No","675","0","108490","236","109401","0.03"
"2025-09-10T09:01:04.345Z","Included","auto","No","1525","0","159323","1028","161876","0.05"
"2025-09-10T09:00:20.972Z","Included","auto","No","1164","0","103249","502","104915","0.03"
"2025-09-10T08:58:57.084Z","Included","auto","No","1412","0","201816","1179","204407","0.06"
"2025-09-10T08:56:40.463Z","Included","auto","No","1580","0","195928","1120","198628","0.06"
"2025-09-10T08:54:44.892Z","Included","auto","No","3100","0","233634","1279","238013","0.07"
"2025-09-10T08:53:52.176Z","Included","auto","No","3169","0","219468","1444","224081","0.06"
"2025-09-10T08:51:24.925Z","Included","auto","No","12175","0","312193","6694","331062","0.12"
"2025-09-10T08:50:00.600Z","Included","auto","No","5941","0","110939","922","117802","0.04"
"2025-09-10T08:48:50.131Z","Included","auto","No","20911","0","159060","3390","183361","0.07"
"2025-09-10T08:45:49.852Z","Errored, Not Charged","auto","No","0","1449","391873","26786","420108","0.11"
"2025-09-10T08:44:45.934Z","Errored, Not Charged","auto","No","0","0","0","0","0","0.00"
"2025-09-10T08:34:16.914Z","Included","auto","No","196176","59326","1175246","13427","1444175","0.55"
"2025-09-10T08:32:31.330Z","Included","auto","No","22202","0","2328087","1545","2351834","0.61"
"2025-09-10T08:31:45.443Z","Included","auto","No","15932","0","61769","347","78048","0.03"
"2025-09-10T08:21:28.390Z","Included","auto","No","3534","0","419167","2080","424781","0.12"
"2025-09-10T08:17:27.807Z","Included","auto","No","3098","0","395855","2067","401020","0.11"
"2025-09-10T08:04:43.173Z","Included","auto","No","5455","0","470885","2661","479001","0.13"
"2025-09-10T08:03:28.315Z","Included","auto","No","6471","0","419596","3172","429239","0.12"
"2025-09-10T08:01:52.415Z","Included","auto","No","3656","0","412360","2149","418165","0.12"
"2025-09-10T08:00:12.239Z","Included","auto","No","1413","0","154958","1078","157449","0.04"
"2025-09-10T07:58:23.782Z","Included","auto","No","1903","0","110971","1632","114506","0.04"
"2025-09-10T07:56:21.863Z","Included","auto","No","1402","0","142157","761","144320","0.04"
"2025-09-10T07:48:35.933Z","Included","auto","No","2317","0","167876","1838","172031","0.05"
"2025-09-10T07:46:30.672Z","Included","auto","No","3198","0","154043","1388","158629","0.05"
"2025-09-10T07:45:11.324Z","Included","auto","No","22328","0","64453","1173","87954","0.04"
"2025-09-10T07:43:00.462Z","Included","auto","No","4694","0","255443","2486","262623","0.08"
"2025-09-10T07:39:18.596Z","Errored, Not Charged","auto","No","17194","0","123784","956","141934","0.05"
"2025-09-10T07:36:34.667Z","Included","auto","No","0","1276","106880","344","108500","0.02"
"2025-09-10T07:35:31.060Z","Included","auto","No","0","654","106368","471","107493","0.02"
"2025-09-10T07:33:13.561Z","Included","auto","No","0","927","105600","518","107045","0.02"
"2025-09-10T07:31:51.561Z","Included","auto","No","0","669","105088","1533","107290","0.03"
"2025-09-10T07:27:08.832Z","Included","auto","No","0","99129","6144","750","106023","0.13"
"2025-09-10T07:26:34.386Z","Included","auto","No","4307","0","99359","315","103981","0.03"
"2025-09-10T07:24:29.907Z","Included","auto","No","2340","0","1201928","741","1205009","0.31"
"2025-09-10T07:11:15.826Z","Included","auto","No","23473","0","2209495","1945","2234913","0.58"
"2025-09-10T07:10:30.601Z","Included","auto","No","4558","0","70877","332","75767","0.02"
"2025-09-10T07:09:52.352Z","Included","auto","No","658","0","70220","414","71292","0.02"
"2025-09-10T07:08:44.993Z","Included","auto","No","4295","0","65926","526","70747","0.02"
"2025-09-10T07:08:25.598Z","Included","auto","No","488","0","65439","405","66332","0.02"
"2025-09-10T07:08:00.770Z","Included","auto","No","567","0","64873","391","65831","0.02"
"2025-09-10T07:07:15.017Z","Included","auto","No","4714","0","60160","469","65343","0.02"
"2025-09-10T07:01:01.151Z","Included","auto","No","36610","0","144404","626","181640","0.08"
"2025-09-10T06:52:18.542Z","Included","auto","No","50696","88888","901579","13128","1054291","0.34"
"2025-09-10T06:50:43.665Z","Included","auto","No","2128","0","97712","393","100233","0.03"
"2025-09-10T06:47:53.501Z","Included","auto","No","29220","0","1502536","3234","1534990","0.42"
"2025-09-10T06:46:57.376Z","Included","auto","No","506","0","68004","380","68890","0.02"
"2025-09-10T06:45:59.266Z","Included","auto","No","1590","0","66415","398","68403","0.02"
"2025-09-10T06:44:46.657Z","Included","auto","No","60557","0","475303","688","536548","0.18"
"2025-09-10T06:11:00.771Z","Included","auto","No","58551","0","1870726","9464","1938741","0.56"
"2025-09-10T06:08:48.882Z","Included","auto","No","22346","63437","8599","8973","103355","0.07"
"2025-09-10T06:05:09.137Z","Included","auto","No","11829","0","949380","3460","964669","0.26"
"2025-09-10T06:02:47.228Z","Included","auto","No","13257","0","274697","2782","290736","0.09"
"2025-09-10T06:00:52.918Z","Included","auto","No","10402","0","996120","3705","1010227","0.27"
"2025-09-10T05:54:53.311Z","Included","auto","No","13548","0","846098","2560","862206","0.24"
"2025-09-10T05:50:51.514Z","Included","auto","No","8516","0","432024","5855","446395","0.14"
"2025-09-10T05:49:09.335Z","Included","auto","No","7007","0","590108","3475","600590","0.17"
"2025-09-10T05:46:48.061Z","Included","auto","No","2895","0","57554","442","60891","0.02"
"2025-09-10T05:41:54.565Z","Included","auto","No","11097","0","1468516","2755","1482368","0.39"
"2025-09-10T05:40:49.549Z","Included","auto","No","10608","0","354421","1352","366381","0.10"
"2025-09-10T05:37:51.692Z","Included","auto","No","9643","0","383931","4664","398238","0.12"
"2025-09-10T05:34:54.449Z","Included","auto","No","26104","0","33090","6402","65596","0.06"
"2025-09-10T05:33:59.218Z","Included","auto","No","4029","0","44646","3627","52302","0.03"
"2025-09-10T05:30:50.867Z","Included","auto","No","3759","0","56661","3983","64403","0.03"
"2025-09-10T05:30:14.995Z","Errored, Not Charged","auto","No","0","0","0","0","0","0.00"
"2025-09-10T05:26:37.967Z","Included","auto","No","9104","86617","8587","7505","111813","0.05"
"2025-09-10T05:24:09.464Z","Included","auto","No","717","0","108577","424","109718","0.03"
"2025-09-10T05:22:21.611Z","Included","auto","No","638","0","107940","562","109140","0.03"
"2025-09-10T05:21:54.955Z","Included","auto","No","6332","0","101609","493","108434","0.03"
"2025-09-10T05:20:22.574Z","Included","auto","No","1384","29610","100226","1254","132474","0.04"
"2025-09-10T05:15:30.186Z","Included","auto","No","2434","0","295868","1300","299602","0.08"
"2025-09-10T05:14:41.584Z","Included","auto","No","2168","0","482858","1305","486331","0.13"
"2025-09-10T05:13:52.091Z","Included","auto","No","4351","0","466959","2450","473760","0.13"
"2025-09-10T05:12:39.093Z","Included","auto","No","23577","0","694972","1531","720080","0.20"
"2025-09-10T05:03:10.877Z","Included","auto","No","11363","0","671570","4505","687438","0.20"
"2025-09-10T05:02:04.444Z","Included","auto","No","6067","0","748653","2074","756794","0.20"
"2025-09-10T05:00:45.349Z","Included","auto","No","4553","1409","382507","2831","391300","0.12"
"2025-09-10T04:54:52.147Z","Included","auto","No","4764","1143","302216","3416","311539","0.10"
"2025-09-10T04:51:16.377Z","Included","auto","No","5384","0","382113","2701","390198","0.11"
"2025-09-10T04:38:59.403Z","Included","auto","No","8035","0","27602","455","36092","0.02"
"2025-09-10T04:35:43.494Z","Included","auto","No","20563","414","394740","8973","424690","0.17"
"2025-09-10T04:33:39.233Z","Errored, Not Charged","auto","No","0","342281","0","16865","359146","0.11"
"2025-09-10T00:15:14.550Z","Errored, Not Charged","auto","No","133286","113222","3677322","39362","3963192","1.21"
"2025-09-10T00:12:50.622Z","Included","auto","No","1843","0","742631","791","745265","0.19"
"2025-09-10T00:09:31.056Z","Included","auto","No","7721","0","593470","830","602021","0.16"
"2025-09-10T00:06:36.131Z","Included","auto","No","8688","0","1336651","1041","1346380","0.35"
"2025-09-10T00:06:17.245Z","Included","auto","No","457","0","74996","329","75782","0.02"
"2025-09-10T00:05:26.688Z","Included","auto","No","29694","0","45303","312","75309","0.04"
"2025-09-10T00:03:56.105Z","Included","auto","No","38246","0","95542","1606","135394","0.07"
"2025-09-10T00:00:28.793Z","Included","auto","No","35133","96354","8242","14885","154614","0.10"
"2025-09-09T23:59:43.157Z","Errored, Not Charged","auto","No","0","0","0","0","0","0.00"
"2025-09-09T23:55:58.912Z","Included","auto","No","2176","0","367573","1759","371508","0.10"
"2025-09-09T23:53:57.758Z","Included","auto","No","4404","0","86676","372","91452","0.03"
"2025-09-09T23:52:09.183Z","Included","auto","No","5144","0","81533","359","87036","0.03"
"2025-09-09T23:51:47.392Z","Included","auto","No","5268","0","76266","538","82072","0.03"
"2025-09-09T23:51:24.964Z","Included","auto","No","4996","0","71271","482","76749","0.02"
"2025-09-09T23:50:16.513Z","Included","auto","No","5509","0","65763","408","71680","0.02"
"2025-09-09T23:42:20.184Z","Included","auto","No","5336","0","60428","612","66376","0.02"
"2025-09-09T23:39:04.069Z","Included","auto","No","7518","2704","288187","2565","300974","0.10"
"2025-09-09T23:29:52.258Z","Included","auto","No","4940","0","47976","154","53070","0.02"
"2025-09-09T23:29:34.535Z","Included","auto","No","5044","0","42933","164","48141","0.02"
"2025-09-09T23:29:00.534Z","Included","auto","No","11520","0","31414","248","43182","0.02"
"2025-09-09T23:20:06.468Z","Included","auto","No","53610","97691","557841","13501","722643","0.26"
"2025-09-09T23:15:34.195Z","Included","auto","No","9957","12412","1836807","4488","1863664","0.53"
"2025-09-09T23:14:28.536Z","Included","auto","No","4936","0","301029","639","306604","0.08"
"2025-09-09T23:11:47.796Z","Included","auto","No","1795","2932","482299","1283","488309","0.14"
"2025-09-09T22:57:41.163Z","Included","auto","No","93591","0","1633173","3155","1729919","0.51"
"2025-09-09T22:53:05.641Z","Included","auto","No","7487","0","759986","943","768416","0.20"
"2025-09-09T22:50:31.965Z","Included","auto","No","564","0","236443","338","237345","0.06"
"2025-09-09T22:49:26.107Z","Included","auto","No","2904","0","620517","680","624101","0.16"
"2025-09-09T22:45:21.260Z","Included","auto","No","23213","0","613755","740","637708","0.18"
"2025-09-09T22:42:36.091Z","Included","auto","No","9086","0","1143353","2447","1154886","0.30"
"2025-09-09T22:39:53.952Z","Included","auto","No","18450","0","1006956","2176","1027582","0.28"
"2025-09-09T22:33:43.800Z","Included","auto","No","41988","85748","330191","7176","465103","0.16"
"2025-09-09T22:26:04.706Z","Included","auto","No","10854","0","2926289","3209","2940352","0.76"
"2025-09-09T22:20:28.140Z","Included","auto","No","8081","0","1450340","2608","1461029","0.38"
"2025-09-09T22:19:28.591Z","Included","auto","No","1161","0","261705","237","263103","0.07"
"2025-09-09T22:00:23.455Z","Included","auto","No","87554","28050","2333755","8831","2458190","0.81"
"2025-09-09T21:51:55.927Z","Included","auto","No","91623","4013","1770940","3622","1870198","0.86"
"2025-09-09T21:45:41.321Z","Included","auto","No","32941","5744","2436750","8883","2484318","0.70"
"2025-09-09T21:45:04.816Z","Included","auto","No","415","0","30471","329","31215","0.01"
"2025-09-09T21:44:32.767Z","Included","auto","No","1622","0","28850","314","30786","0.01"
"2025-09-09T21:21:45.564Z","Included","auto","No","398","0","28453","233","29084","0.01"
"2025-09-09T21:21:20.914Z","Included","auto","No","334","0","28120","255","28709","0.01"
"2025-09-09T21:18:33.358Z","Included","auto","No","1407","0","81993","511","83911","0.02"
"2025-09-09T21:10:59.613Z","Included","auto","No","8199","1533","227720","3192","240644","0.09"
"2025-09-09T21:09:14.586Z","Included","auto","No","26753","1425","101021","3384","132583","0.16"
"2025-09-09T21:03:36.934Z","Included","auto","No","8111","616","98715","4823","112265","0.08"
"2025-09-09T21:01:02.309Z","Included","auto","No","93285","0","502700","1423","597408","0.22"
"2025-09-09T20:57:02.359Z","Included","auto","No","1304","0","381287","503","383094","0.10"
"2025-09-09T20:55:14.408Z","Included","auto","No","1541","0","375561","678","377780","0.10"
"2025-09-09T20:51:47.719Z","Included","auto","No","1529","0","369447","700","371676","0.10"
"2025-09-09T20:50:07.899Z","Included","auto","No","3985","0","541063","1032","546080","0.14"
"2025-09-09T20:45:00.684Z","Included","auto","No","4099","6636","770805","2650","784190","0.23"
"2025-09-09T20:42:40.627Z","Errored, Not Charged","auto","No","4204","4204","815197","2608","826213","0.24"
"2025-09-09T20:42:06.574Z","Included","auto","No","3131","0","466064","1371","470566","0.13"
"2025-09-09T20:40:24.146Z","Included","auto","No","5747","0","593819","1819","601385","0.16"
"2025-09-09T20:37:02.327Z","Included","auto","No","6185","0","272803","1222","280210","0.08"
"2025-09-09T20:34:10.973Z","Included","auto","No","4037","0","375854","1262","381153","0.10"
"2025-09-09T20:31:49.921Z","Included","auto","No","2438","0","295813","1109","299360","0.08"
"2025-09-09T20:26:06.210Z","Included","auto","No","6348","0","542185","3353","551886","0.16"
"2025-09-09T20:25:21.694Z","Included","auto","No","1529","0","202730","681","204940","0.05"
"2025-09-09T20:23:43.635Z","Included","auto","No","1764","0","196212","804","198780","0.05"
"2025-09-09T20:21:34.101Z","Included","auto","No","22119","0","262758","1050","285927","0.09"
"2025-09-09T20:17:01.707Z","Included","auto","No","35028","81262","574127","14896","705313","0.25"
"2025-09-09T20:12:57.954Z","Included","auto","No","11916","0","1454019","5423","1471358","0.40"
"2025-09-09T20:06:32.568Z","Included","auto","No","13415","0","1974797","5611","1993823","0.53"
"2025-09-09T19:58:06.130Z","Included","auto","No","107226","0","732819","8146","848191","0.32"
"2025-09-09T19:54:15.374Z","Included","auto","No","10752","0","610997","8033","629782","0.20"
"2025-09-09T19:50:41.154Z","Included","auto","No","44717","0","1100267","7379","1152363","0.35"
"2025-09-09T19:45:18.450Z","Included","auto","No","74620","79019","999764","23809","1177212","0.42"
"2025-09-09T19:43:53.969Z","Included","auto","No","974","0","324469","476","325919","0.08"
"2025-09-09T19:42:16.754Z","Included","auto","No","5289","0","1265213","2346","1272848","0.33"
"2025-09-09T19:38:05.243Z","Included","auto","No","4735","0","805880","1322","811937","0.21"
"2025-09-09T19:35:14.355Z","Included","auto","No","9122","0","1964585","3090","1976797","0.51"
"2025-09-09T19:31:13.855Z","Included","auto","No","12699","0","1344479","3261","1360439","0.36"
"2025-09-09T19:26:18.961Z","Included","auto","No","73970","0","398393","3587","475950","0.19"
"2025-09-09T19:19:12.413Z","Included","auto","No","38832","0","1140606","3302","1182740","0.34"
"2025-09-09T19:14:41.238Z","Included","auto","No","83778","53895","1006190","20386","1164249","0.42"
"2025-09-09T19:10:56.749Z","Included","auto","No","24097","0","2073688","12356","2110141","0.59"
"2025-09-09T19:05:49.651Z","Included","auto","No","36202","0","2900583","14883","2951668","0.82"
"2025-09-09T19:00:02.512Z","Included","auto","No","43025","0","937409","23303","1003737","0.37"
"2025-09-08T05:05:21.533Z","Errored, Not Charged","auto","No","0","0","0","0","0","0.00"
"2025-09-08T04:58:43.748Z","Included","auto","No","0","1982","637184","17007","656173","0.25"
"2025-09-08T04:54:14.435Z","Included","auto","No","0","1719","632576","11621","645916","0.20"
"2025-09-08T04:48:07.552Z","Included","auto","No","0","1421","628864","15891","646176","0.24"
"2025-09-08T04:38:47.015Z","Included","auto","No","0","209425","417280","19444","646149","0.51"
"2025-09-08T04:34:38.579Z","Included","auto","No","0","589","207872","10486","218947","0.13"
"2025-09-08T04:21:23.597Z","Included","auto","No","0","13344","2197120","34473","2244937","0.64"
"2025-09-08T04:19:55.430Z","Included","auto","No","0","2429","386688","2748","391865","0.08"
"2025-09-08T04:19:11.802Z","Included","auto","No","0","1519","384128","988","386635","0.06"
"2025-09-08T04:18:17.260Z","Included","auto","No","0","1850","572544","1798","576192","0.09"
"2025-09-08T04:15:52.512Z","Included","auto","No","0","6836","1677824","3673","1688333","0.26"
"2025-09-08T04:15:08.049Z","Included","auto","No","0","1629","366464","1379","369472","0.06"
"2025-09-08T04:14:04.799Z","Included","auto","No","0","4108","905728","1502","911338","0.13"
"2025-09-08T04:13:13.717Z","Included","auto","No","0","1920","533504","1404","536828","0.08"
"2025-09-08T04:11:05.964Z","Included","auto","No","0","4114","1578368","3422","1585904","0.24"
"2025-09-08T04:09:52.852Z","Included","auto","No","0","1996","690560","1898","694454","0.11"
"2025-09-08T04:09:21.509Z","Included","auto","No","0","1390","342528","341","344259","0.05"
"2025-09-08T04:07:40.525Z","Included","auto","No","0","2944","1018496","2107","1023547","0.15"
"2025-09-08T04:06:17.105Z","Included","auto","No","0","3567","835456","2376","841399","0.13"
"2025-09-08T04:05:35.603Z","Included","auto","No","0","1405","328960","1340","331705","0.06"
"2025-09-08T04:02:09.677Z","Included","auto","No","0","5939","1131008","7048","1143995","0.22"
"2025-09-08T03:59:33.793Z","Included","auto","No","0","5987","1250048","5148","1261183","0.22"
"2025-09-08T03:56:52.547Z","Included","auto","No","0","5716","1207168","6042","1218926","0.22"
"2025-09-08T03:51:25.642Z","Included","auto","No","0","8944","2014592","10729","2034265","0.37"
"2025-09-08T03:49:36.090Z","Included","auto","No","0","3726","690560","4558","698844","0.14"
"2025-09-08T03:48:09.473Z","Included","auto","No","0","3294","810624","2351","816269","0.13"
"2025-09-08T03:45:25.796Z","Included","auto","No","0","3636","527360","5637","536633","0.13"
"2025-09-08T03:44:01.397Z","Included","auto","No","0","3421","902912","2964","909297","0.15"
"2025-09-08T03:41:48.040Z","Included","auto","No","0","6134","1501568","4733","1512435","0.24"
"2025-09-08T03:39:36.275Z","Included","auto","No","0","8774","1307264","4927","1320965","0.22"
"2025-09-08T03:37:20.034Z","Included","auto","No","0","10876","1209600","4606","1225082","0.21"
"2025-09-08T03:35:41.022Z","Included","auto","No","0","4201","716800","3534","724535","0.13"
"2025-09-08T03:34:22.024Z","Included","auto","No","0","4763","786432","3833","795028","0.14"
"2025-09-08T03:32:06.844Z","Included","auto","No","0","4580","753024","6249","763853","0.16"
"2025-09-08T03:26:25.941Z","Included","auto","No","0","96317","842496","13523","952336","0.36"
"2025-09-08T03:25:15.816Z","Included","auto","No","0","6338","204800","1837","212975","0.05"
"2025-09-08T03:17:41.522Z","Errored, Not Charged","auto","No","0","57941","478720","15631","552292","0.29"
"2025-09-08T03:15:38.793Z","Included","auto","No","0","20490","1084672","3599","1108761","0.20"
"2025-09-08T03:13:03.737Z","Included","auto","No","0","23154","1961472","3925","1988551","0.31"
"2025-09-08T03:11:58.031Z","Included","auto","No","0","1316","385920","1874","389110","0.07"
"2025-09-08T03:11:01.614Z","Included","auto","No","0","1425","383360","1709","386494","0.07"
"2025-09-08T03:09:02.966Z","Included","auto","No","0","6795","1698176","3085","1708056","0.25"
"2025-09-08T03:08:06.138Z","Included","auto","No","0","1584","367744","1932","371260","0.07"
"2025-09-08T03:06:29.772Z","Included","auto","No","0","3786","1272320","2752","1278858","0.19"
"2025-09-08T03:04:21.109Z","Included","auto","No","0","4276","1426688","3716","1434680","0.22"
"2025-09-08T03:03:43.705Z","Included","auto","No","0","1148","351616","1790","354554","0.06"
"2025-09-08T03:02:42.638Z","Included","auto","No","0","1246","349696","1104","352046","0.06"
"2025-09-08T03:01:38.637Z","Included","auto","No","0","1475","520960","1859","524294","0.09"
"2025-09-08T02:59:28.683Z","Included","auto","No","0","5056","1535872","4043","1544971","0.24"
"2025-09-08T02:57:58.357Z","Included","auto","No","0","3729","1167744","2516","1173989","0.18"
"2025-09-08T02:56:34.213Z","Included","auto","No","0","3367","1144576","2082","1150025","0.17"
"2025-09-08T02:54:18.117Z","Included","auto","No","0","4838","1279232","3966","1288036","0.21"
"2025-09-08T02:52:08.548Z","Included","auto","No","0","6010","1392768","3703","1402481","0.22"
"2025-09-08T02:51:15.985Z","Included","auto","No","0","881","304256","1650","306787","0.06"
"2025-09-08T02:50:24.734Z","Included","auto","No","0","1218","302464","1561","305243","0.05"
"2025-09-08T02:49:16.503Z","Included","auto","No","0","5268","594304","1886","601458","0.10"
"2025-09-08T02:48:23.501Z","Included","auto","No","0","11985","283136","1752","296873","0.07"
"2025-09-08T02:45:49.404Z","Included","auto","No","0","4653","1291776","4950","1301379","0.22"
"2025-09-08T02:44:06.488Z","Included","auto","No","0","2115","420736","3680","426531","0.09"
"2025-09-08T02:40:26.559Z","Included","auto","No","0","19247","1745408","7021","1771676","0.31"
"2025-09-08T02:38:35.706Z","Included","auto","No","0","5663","902656","3281","911600","0.15"
"2025-09-08T02:37:42.424Z","Included","auto","No","0","3036","376320","1909","381265","0.07"
"2025-09-08T02:36:29.222Z","Included","auto","No","0","18380","357248","2290","377918","0.09"
"2025-09-08T02:35:17.865Z","Included","auto","No","0","1677","370048","2976","374701","0.08"
"2025-09-08T02:33:51.148Z","Included","auto","No","0","21425","561536","2054","585015","0.12"
"2025-09-08T02:32:25.442Z","Included","auto","No","0","2560","424320","3014","429894","0.09"
"2025-09-08T02:29:07.220Z","Included","auto","No","0","7686","1019136","6740","1033562","0.20"
"2025-09-08T02:24:47.232Z","Included","auto","No","0","32024","1320960","9076","1362060","0.30"
"2025-09-08T02:23:37.466Z","Included","auto","No","0","2531","427392","3364","433287","0.09"
"2025-09-08T02:22:30.130Z","Included","auto","No","0","64926","519296","2180","586402","0.17"
"2025-09-08T02:21:23.823Z","Included","auto","No","0","1793","321152","1958","324903","0.06"
"2025-09-08T02:20:36.822Z","Included","auto","No","0","1250","157568","2260","161078","0.04"
"2025-09-08T02:17:31.915Z","Included","auto","No","0","13847","744320","8588","766755","0.20"
"2025-09-08T02:16:26.610Z","Included","auto","No","0","43635","150912","1886","196433","0.09"
"2025-09-08T02:02:18.829Z","Errored, Not Charged","auto","No","0","164544","11520","8871","184935","0.07"
"2025-09-08T02:01:10.678Z","Included","auto","No","0","1711","691712","1784","695207","0.11"
"2025-09-08T02:00:13.420Z","Included","auto","No","0","1233","458624","2394","462251","0.08"
"2025-09-08T01:58:41.650Z","Included","auto","No","0","1606","913152","2246","917004","0.14"
"2025-09-08T01:57:08.356Z","Included","auto","No","0","4996","898560","2221","905777","0.14"
"2025-09-08T01:56:35.547Z","Included","auto","No","0","718","445824","691","447233","0.06"
"2025-09-08T01:55:49.763Z","Included","auto","No","0","898","444544","1248","446690","0.07"
"2025-09-08T01:54:35.771Z","Included","auto","No","0","1344","664064","2097","667505","0.11"
"2025-09-08T01:52:41.763Z","Included","auto","No","0","3453","1314304","3086","1320843","0.20"
"2025-09-08T01:48:33.305Z","Included","auto","No","0","4073","1725696","3254","1733023","0.25"
"2025-09-08T01:47:26.938Z","Included","auto","No","0","4583","424704","622","429909","0.07"
"2025-09-08T01:44:03.712Z","Included","auto","No","0","11434","1683968","3783","1699185","0.26"
"2025-09-08T01:40:55.433Z","Included","auto","No","0","975","419328","874","421177","0.06"
"2025-09-08T01:37:09.370Z","Included","auto","No","0","3879","2075136","3548","2082563","0.30"
"2025-09-08T01:34:57.551Z","Included","auto","No","0","2238","819328","2115","823681","0.13"
"2025-09-08T01:32:19.432Z","Included","auto","No","0","6245","808192","1834","816271","0.13"
"2025-09-08T01:29:32.008Z","Included","auto","No","0","1859","807040","1420","810319","0.12"
"2025-09-08T01:22:21.330Z","Included","auto","No","0","14177","1184640","3521","1202338","0.20"
"2025-09-08T01:20:11.717Z","Included","auto","No","0","2525","786816","2011","791352","0.12"
"2025-09-08T01:18:41.883Z","Included","auto","No","0","3296","387584","1144","392024","0.06"
"2025-09-08T01:17:09.187Z","Included","auto","No","0","3703","189184","383","193270","0.03"
"2025-09-08T01:13:36.880Z","Included","auto","No","0","6260","748032","2114","756406","0.12"
"2025-09-08T01:11:17.055Z","Included","auto","No","0","3399","1116160","4139","1123698","0.19"
"2025-09-08T01:09:06.497Z","Included","auto","No","0","3237","733952","1661","738850","0.11"
"2025-09-08T01:07:46.965Z","Included","auto","No","0","2273","546048","2193","550514","0.09"
"2025-09-08T01:05:56.738Z","Included","auto","No","0","1873","361728","2045","365646","0.07"
"2025-09-08T01:02:20.653Z","Included","auto","No","0","3562","358272","2195","364029","0.07"
"2025-09-08T00:59:34.655Z","Included","auto","No","0","12942","524672","4586","542200","0.13"
"2025-09-08T00:56:15.953Z","Included","auto","No","0","967","354688","1645","357300","0.06"
"2025-09-08T00:54:35.666Z","Included","auto","No","0","10877","670720","2180","683777","0.12"
"2025-09-08T00:53:41.438Z","Included","auto","No","0","1057","166272","1222","168551","0.03"
"2025-09-08T00:50:31.876Z","Included","auto","No","0","11773","653952","1983","667708","0.12"
"2025-09-08T00:48:15.981Z","Included","auto","No","0","346","165376","681","166403","0.03"
"2025-09-08T00:46:16.878Z","Included","auto","No","0","3999","812800","3105","819904","0.14"
"2025-09-08T00:42:56.851Z","Included","auto","No","0","4396","792448","3510","800354","0.14"
"2025-09-08T00:38:46.033Z","Included","auto","No","0","3745","937472","3932","945149","0.16"
"2025-09-08T00:34:59.276Z","Included","auto","No","0","22586","2107392","6169","2136147","0.35"
"2025-09-08T00:32:50.496Z","Included","auto","No","0","3643","863232","2951","869826","0.14"
"2025-09-08T00:31:05.869Z","Included","auto","No","0","1702","284032","1963","287697","0.06"
"2025-09-08T00:26:53.191Z","Included","auto","No","0","4967","986240","3929","995136","0.17"
"2025-09-08T00:23:02.476Z","Included","auto","No","0","27146","1309952","4850","1341948","0.25"
"2025-09-08T00:19:48.404Z","Included","auto","No","0","3264","633600","4184","641048","0.13"
"2025-09-08T00:16:42.243Z","Included","auto","No","0","24872","1739776","4732","1769380","0.30"
"2025-09-08T00:15:27.609Z","Included","auto","No","0","737","225920","2639","229296","0.06"
"2025-09-08T00:13:42.193Z","Included","auto","No","0","115151","779904","2656","897711","0.27"
"2025-09-08T00:11:28.729Z","Included","auto","No","0","111096","764544","3992","879632","0.27"
"2025-09-07T23:54:31.138Z","Included","auto","No","0","3736","849792","5831","859359","0.17"
"2025-09-07T23:48:49.818Z","Included","auto","No","0","28678","1382912","10069","1421659","0.31"
"2025-09-07T23:45:38.976Z","Included","auto","No","0","30696","582272","2565","615533","0.14"
"2025-09-07T23:43:26.370Z","Included","auto","No","0","1965","332288","2624","336877","0.07"
"2025-09-07T23:39:56.002Z","Included","auto","No","0","6545","231936","9829","248310","0.14"
"2025-09-07T23:38:01.524Z","Included","auto","No","0","7969","703616","3621","715206","0.13"
"2025-09-07T23:35:55.916Z","Included","auto","No","0","6309","466688","4011","477008","0.11"
"2025-09-07T23:34:25.691Z","Included","auto","No","0","1899","259200","2838","263937","0.06"
"2025-09-07T23:30:02.770Z","Included","auto","No","0","64125","795648","7552","867325","0.26"
"2025-09-07T23:26:52.483Z","Included","auto","No","0","3146","514176","4888","522210","0.12"
"2025-09-07T23:24:01.754Z","Included","auto","No","0","7086","529152","5945","542183","0.13"
"2025-09-07T23:20:00.143Z","Included","auto","No","0","8663","352640","8787","370090","0.14"
"2025-09-07T23:15:44.346Z","Included","auto","No","0","6736","383872","5456","396064","0.11"
"2025-09-07T23:13:36.920Z","Included","auto","No","0","4827","67840","3229","75896","0.05"
"2025-09-07T23:10:22.647Z","Included","auto","No","0","33629","148608","5174","187411","0.11"
"2025-09-07T23:04:07.138Z","Included","auto","No","0","193340","178688","11908","383936","0.17"
"2025-09-07T23:00:43.515Z","Included","auto","No","0","2070","894848","1690","898608","0.13"
"2025-09-07T22:57:36.684Z","Included","auto","No","0","217225","1560064","4219","1781508","0.51"
"2025-09-07T22:54:53.934Z","Included","auto","No","0","13631","863360","2357","879348","0.15"
"2025-09-07T22:36:08.438Z","Included","auto","No","0","2736","642432","1572","646740","0.10"
"2025-09-07T22:33:45.099Z","Included","auto","No","0","4496","1050880","1705","1057081","0.15"
"2025-09-07T22:32:13.506Z","Included","auto","No","0","6053","1031936","1892","1039881","0.16"
"2025-09-07T22:30:19.352Z","Included","auto","No","0","207740","816128","1350","1025218","0.38"
"2025-09-07T22:28:20.507Z","Included","auto","No","0","4302","1407360","1502","1413164","0.20"
"2025-09-07T22:27:12.958Z","Included","auto","No","0","2742","790656","1315","794713","0.12"
"2025-09-07T22:26:05.759Z","Included","auto","No","0","2078","586624","915","589617","0.09"
"2025-09-07T22:24:06.998Z","Included","auto","No","0","3987","1156608","1926","1162521","0.17"
"2025-09-07T22:21:08.228Z","Included","auto","No","0","3495","1326976","2408","1332879","0.19"
"2025-09-07T22:19:32.930Z","Included","auto","No","0","2145","560896","838","563879","0.08"
"2025-09-07T22:18:15.101Z","Included","auto","No","0","1946","369792","811","372549","0.06"
"2025-09-07T22:16:54.626Z","Included","auto","No","0","5642","541568","1508","548718","0.09"
"2025-09-07T22:14:37.595Z","Included","auto","No","0","4032","708608","2828","715468","0.12"
"2025-09-07T22:09:10.932Z","Included","auto","No","0","174255","1571200","4132","1749587","0.46"
"2025-09-07T22:07:47.560Z","Included","auto","No","0","1114","343680","1319","346113","0.06"
"2025-09-07T22:05:32.483Z","Included","auto","No","0","1787","852992","1513","856292","0.12"
"2025-09-07T22:03:06.992Z","Included","auto","No","0","2894","1010432","2709","1016035","0.16"
"2025-09-07T21:59:12.162Z","Included","auto","No","0","11217","1933952","6230","1951399","0.32"
"2025-09-07T21:56:02.454Z","Included","auto","No","0","5653","1691520","3616","1700789","0.25"
"2025-09-07T21:50:48.966Z","Included","auto","No","0","6445","2088192","6873","2101510","0.34"
"2025-09-07T21:47:37.960Z","Included","auto","No","0","2844","1014784","2643","1020271","0.16"
"2025-09-07T21:45:06.202Z","Included","auto","No","0","2319","855808","3451","861578","0.14"
"2025-09-07T21:43:09.291Z","Included","auto","No","0","1890","563072","1892","566854","0.09"
"2025-09-07T21:37:56.092Z","Included","auto","No","0","6102","1782912","8053","1797067","0.31"
"2025-09-07T21:33:13.202Z","Included","auto","No","0","2124","802560","5172","809856","0.15"
"2025-09-07T21:22:53.052Z","Included","auto","No","0","25138","2946432","16651","2988221","0.57"
"2025-09-07T21:21:24.594Z","Included","auto","No","0","1034","217216","2576","220826","0.05"
"2025-09-07T21:17:47.196Z","Included","auto","No","0","1796","537216","5576","544588","0.13"
"2025-09-07T21:13:17.839Z","Included","auto","No","0","101095","848128","5326","954549","0.29"
"2025-09-07T21:10:53.884Z","Included","auto","No","0","3438","611712","3958","619108","0.12"
"2025-09-07T21:07:30.447Z","Included","auto","No","0","1869","597120","1928","600917","0.10"
"2025-09-07T21:04:55.063Z","Included","auto","No","0","94902","689280","2661","786843","0.23"
"2025-09-07T21:01:24.505Z","Included","auto","No","0","6800","1599744","7021","1613565","0.28"
"2025-09-07T20:42:22.944Z","Included","auto","No","0","48736","3991808","20013","4060557","0.76"
"2025-09-07T20:34:56.877Z","Included","auto","No","0","17286","978944","17797","1014027","0.32"
"2025-09-07T20:29:06.601Z","Included","auto","No","0","24119","125312","16710","166141","0.21"
"2025-09-07T20:25:55.247Z","Included","auto","No","0","20117","16256","10618","46991","0.13"
"2025-09-07T20:22:48.474Z","Included","auto","No","0","1346","104576","3568","109490","0.05"
"2025-09-07T20:20:19.045Z","Included","auto","No","0","2492","102144","3680","108316","0.05"
"2025-09-07T20:18:11.802Z","Included","auto","No","0","1592","100608","4318","106518","0.06"
"2025-09-07T20:16:19.949Z","Included","auto","No","0","1909","98816","4309","105034","0.06"
"2025-09-07T20:14:05.808Z","Included","auto","No","0","2224","96640","4829","103693","0.06"
"2025-09-07T20:10:50.908Z","Included","auto","No","0","1920","94848","4250","101018","0.06"
"2025-09-07T20:07:34.881Z","Included","auto","No","0","3643","91264","5138","100045","0.07"
"2025-09-07T19:58:28.655Z","Included","auto","No","0","23616","137984","9888","171488","0.15"
"2025-09-07T19:53:23.528Z","Included","auto","No","0","22781","94464","6915","124160","0.11"
"2025-09-07T19:51:26.327Z","Included","auto","No","0","8389","40064","3538","51991","0.05"
"2025-09-07T19:47:17.984Z","Included","auto","No","0","604","39552","9373","49529","0.10"
"2025-09-07T19:46:25.494Z","Included","auto","No","0","1044","38528","2038","41610","0.03"
"2025-09-07T19:43:09.413Z","Included","auto","No","0","1317","37248","3392","41957","0.04"
"2025-09-07T19:40:40.014Z","Included","auto","No","0","2162","35840","4821","42823","0.06"
"2025-09-07T19:38:05.327Z","Included","auto","No","0","13268","24064","3774","41106","0.06"
"2025-09-07T19:34:57.666Z","Included","auto","No","0","24059","35968","6907","66934","0.10"
"2025-09-07T19:32:54.518Z","Included","auto","No","0","2252","18176","6334","26762","0.07"
"2025-09-07T19:27:36.221Z","Included","auto","No","0","5310","12928","5940","24178","0.07"
"2025-09-07T19:24:58.220Z","Included","auto","No","0","18366","10240","7285","35891","0.10"
"2025-09-07T19:18:14.359Z","Included","auto","No","0","2198","8064","5305","15567","0.06"
"2025-09-07T19:09:39.613Z","Included","auto","No","0","1612","6528","4426","12566","0.05"
"2025-09-06T00:51:34.071Z","Included","auto","No","0","32500","1929088","4193","1965781","0.32"
"2025-09-06T00:48:24.206Z","Errored, Not Charged","auto","No","0","2469","1061504","4059","1068032","0.18"
"2025-09-06T00:47:14.771Z","Included","auto","No","0","674","300800","892","302366","0.05"
"2025-09-06T00:42:56.317Z","Included","auto","No","0","2524","447616","3264","453404","0.09"
"2025-09-06T00:40:03.099Z","Included","auto","No","0","2856","732416","1762","737034","0.11"
"2025-09-06T00:37:24.979Z","Included","auto","No","0","318","145280","1846","147444","0.04"
"2025-09-06T00:32:37.790Z","Included","auto","No","0","3098","717312","4188","724598","0.14"
"2025-09-06T00:25:51.252Z","Included","auto","No","0","10687","273408","2672","286767","0.07"
"2025-09-06T00:22:37.760Z","Included","auto","No","0","2847","781312","5234","789393","0.15"
"2025-09-06T00:03:34.578Z","Included","auto","No","0","123216","853632","23143","999991","0.49"
"2025-09-05T23:42:21.406Z","Included","auto","No","0","12663","532480","15481","560624","0.24"
"2025-09-05T23:37:51.437Z","Included","auto","No","0","27345","1114240","10321","1151906","0.28"
"2025-09-05T23:30:42.972Z","Included","auto","No","0","60720","1122688","11735","1195143","0.33"
"2025-09-05T23:11:36.716Z","Included","auto","No","0","70960","231680","24363","327003","0.36"
"2025-09-05T23:05:55.305Z","Included","auto","No","0","14844","2811264","5167","2831275","0.42"
"2025-09-05T23:02:06.815Z","Included","auto","No","0","20834","2936320","5194","2962348","0.45"
"2025-09-05T22:55:51.498Z","Included","auto","No","0","22400","1117312","6413","1146125","0.23"
"2025-09-05T22:19:13.036Z","Included","auto","No","0","143386","4927232","73963","5144581","1.53"
"2025-09-05T22:16:26.105Z","Included","auto","No","0","2673","255872","10184","268729","0.14"
"2025-09-05T22:14:03.331Z","Included","auto","No","0","70930","12800","5546","89276","0.15"
"2025-09-05T22:00:38.449Z","Included","auto","No","0","29719","189440","24235","243394","0.30"
"2025-09-05T21:56:19.397Z","Included","auto","No","0","1284","274944","4993","281221","0.09"
"2025-09-05T21:53:39.219Z","Included","auto","No","0","22834","179200","4130","206164","0.09"
"2025-09-05T21:51:52.194Z","Included","auto","No","0","3366","263168","6262","272796","0.10"
"2025-09-05T21:51:22.821Z","Included","auto","No","0","937","42240","1721","44898","0.02"
"2025-09-05T21:44:24.750Z","Included","auto","No","0","2693","284928","4016","291637","0.08"
"2025-09-05T21:39:22.317Z","Included","auto","No","0","11470","382336","14514","408320","0.21"
"2025-09-05T21:38:44.561Z","Included","auto","No","0","467","28032","2113","30612","0.03"
"2025-09-05T21:32:35.096Z","Included","auto","No","0","8273","175744","8358","192375","0.12"
"2025-09-05T21:27:07.693Z","Included","auto","No","0","465736","174208","15983","655927","0.24"
"2025-09-05T21:21:47.667Z","Included","auto","No","0","642","205312","401","206355","0.03"
"2025-09-05T21:16:49.092Z","Included","auto","No","0","5119","1421568","3279","1429966","0.22"
"2025-09-05T21:07:00.752Z","Included","auto","No","0","194366","405888","1863","602117","0.31"
"2025-09-05T20:00:26.084Z","Included","auto","No","0","2064","791424","2925","796413","0.13"
"2025-09-05T19:58:12.733Z","Included","auto","No","0","190914","6400","1701","199015","0.26"
"2025-09-05T19:21:01.707Z","Included","auto","No","0","716","392832","1046","394594","0.06"
"2025-09-05T19:19:15.140Z","Included","auto","No","0","3104","387456","215","390775","0.05"
"2025-09-05T19:17:50.685Z","Included","auto","No","0","521","192896","1558","194975","0.04"
"2025-09-05T19:13:18.437Z","Included","auto","No","0","2457","190592","1138","194187","0.04"
"2025-09-05T19:10:10.404Z","Included","auto","No","0","1913","188800","2005","192718","0.05"
"2025-09-05T19:07:51.809Z","Included","auto","No","0","241","188288","1402","189931","0.04"
"2025-09-05T19:06:22.913Z","Included","auto","No","0","3268","370560","252","374080","0.05"
"2025-09-05T19:02:37.700Z","Included","auto","No","0","178906","6400","1898","187204","0.24"
"2025-09-05T03:04:23.677Z","Included","auto","No","0","1919","183040","1000","185959","0.04"
"2025-09-05T03:01:45.222Z","Included","auto","No","0","920","183168","1375","185463","0.04"
"2025-09-05T02:57:40.082Z","Included","auto","No","0","187099","905600","5667","1098366","0.40"
"2025-09-05T02:57:23.601Z","Errored, Not Charged","auto","No","0","0","0","0","0","0.00"
"2025-09-05T02:54:51.344Z","Included","auto","No","0","3638","352768","317","356723","0.05"
"2025-09-05T02:52:26.031Z","Included","auto","No","0","3847","345472","744","350063","0.06"
"2025-09-05T02:41:14.584Z","Included","auto","No","0","6707","671744","2557","681008","0.12"
"2025-09-05T02:38:33.637Z","Included","auto","No","0","1622","164608","1527","167757","0.04"
"2025-09-05T02:35:26.485Z","Included","auto","No","0","12342","476032","3651","492025","0.11"
"2025-09-05T02:33:53.082Z","Included","auto","No","0","1079","151680","886","153645","0.03"
"2025-09-05T02:32:47.982Z","Included","auto","No","0","549","151296","1163","153008","0.03"
"2025-09-05T02:31:27.673Z","Included","auto","No","0","333","151168","858","152359","0.03"
"2025-09-05T02:29:54.059Z","Included","auto","No","0","25113","403072","3494","431679","0.12"
"2025-09-05T02:27:53.626Z","Included","auto","No","0","1599","124800","1453","127852","0.03"
"2025-09-05T02:20:45.336Z","Included","auto","No","0","2960","740224","7185","750369","0.17"
"2025-09-05T02:18:02.762Z","Included","auto","No","0","2922","966528","5627","975077","0.18"
"2025-09-05T02:16:27.305Z","Included","auto","No","0","1166","359040","2903","363109","0.08"
"2025-09-05T02:15:18.970Z","Included","auto","No","0","3013","233344","1685","238042","0.05"
"2025-09-05T02:11:52.485Z","Included","auto","No","0","1527","346624","2219","350370","0.07"
"2025-09-05T02:02:41.289Z","Included","auto","No","0","3910","564096","2248","570254","0.10"
"2025-09-05T01:49:49.076Z","Included","auto","No","0","112381","1093248","10580","1216209","0.38"
"2025-09-05T01:22:24.366Z","Included","auto","No","0","627","93568","1455","95650","0.03"
"2025-09-05T01:11:01.372Z","Included","auto","No","0","11020","432384","4218","447622","0.11"
"2025-09-05T01:03:43.010Z","Included","auto","No","0","83212","0","2329","85541","0.13"
"2025-09-05T00:44:43.499Z","Included","auto","No","0","417","82560","1132","84109","0.02"
"2025-09-05T00:43:07.275Z","Included","auto","No","0","378","82304","875","83557","0.02"
"2025-09-05T00:33:40.517Z","Included","auto","No","0","2205","323584","4681","330470","0.09"
"2025-09-05T00:28:09.220Z","Included","auto","No","0","2692","393216","3152","399060","0.08"
"2025-09-05T00:23:06.499Z","Included","auto","No","0","4096","529792","6727","540615","0.14"
"2025-09-05T00:20:11.649Z","Included","auto","No","0","4293","213504","3188","220985","0.06"
"2025-09-05T00:10:23.775Z","Included","auto","No","0","561","139776","4055","144392","0.06"
"2025-09-05T00:08:33.331Z","Included","auto","No","0","353","69504","644","70501","0.02"
"2025-09-05T00:07:36.160Z","Included","auto","No","0","1297","137088","429","138814","0.02"
"2025-09-05T00:01:31.541Z","Included","auto","No","0","68522","0","1236","69758","0.10"
"2025-09-04T23:53:10.174Z","Included","auto","No","0","4433","303360","10771","318564","0.15"
"2025-09-04T23:46:59.343Z","Included","auto","No","0","53274","6400","1302","60976","0.08"
"2025-09-04T23:44:14.409Z","Included","auto","No","0","483","58240","2506","61229","0.03"
"2025-09-04T23:39:08.449Z","Included","auto","No","0","10457","250240","5683","266380","0.10"
"2025-09-04T23:35:43.272Z","Included","auto","No","0","376","47744","1509","49629","0.02"
"2025-09-04T23:34:11.374Z","Included","auto","No","0","364","47488","1113","48965","0.02"
"2025-09-04T23:32:54.202Z","Included","auto","No","0","33543","14080","1413","49036","0.06"
"2025-09-04T23:30:04.843Z","Included","auto","No","0","225","231296","701","232222","0.04"
"2025-09-04T23:29:05.526Z","Included","auto","No","0","802","461568","517","462887","0.06"
"2025-09-04T23:28:01.448Z","Included","auto","No","0","425","230272","714","231411","0.04"
"2025-09-04T23:25:51.362Z","Included","auto","No","0","7080","679168","2303","688551","0.12"
"2025-09-04T23:09:08.517Z","Included","auto","No","0","284","223360","33","223677","0.03"
"2025-09-04T23:06:51.563Z","Included","auto","No","0","844","445824","914","447582","0.07"
"2025-09-04T22:52:51.029Z","Included","auto","No","0","2071","663936","1191","667198","0.10"
"2025-09-04T22:42:00.441Z","Included","auto","No","0","323","220928","910","222161","0.04"
"2025-09-04T22:38:45.696Z","Included","auto","No","0","4757","653952","2021","660730","0.11"
"2025-09-04T22:36:48.424Z","Included","auto","No","0","333","216192","1364","217889","0.04"
"2025-09-04T22:35:03.219Z","Included","auto","No","0","920","431104","1129","433153","0.07"
"2025-09-04T22:29:58.224Z","Included","auto","No","0","501","215040","698","216239","0.03"
"2025-09-04T22:29:00.827Z","Included","auto","No","0","424","214784","1008","216216","0.04"
"2025-09-04T22:28:08.299Z","Included","auto","No","0","448","214528","761","215737","0.03"
"2025-09-04T22:21:45.521Z","Included","auto","No","0","208264","6400","1690","216354","0.28"
"2025-09-04T22:07:42.827Z","Included","auto","No","0","384","214784","1257","216425","0.04"
"2025-09-04T22:00:01.242Z","Included","auto","No","0","1851","639872","2440","644163","0.11"
"2025-09-04T21:59:04.987Z","Included","auto","No","0","1877","423040","1562","426479","0.07"
"2025-09-04T21:55:01.811Z","Included","auto","No","0","1139","421120","3746","426005","0.09"
"2025-09-04T21:54:34.544Z","Included","auto","No","0","293","210304","224","210821","0.03"
"2025-09-04T21:52:20.368Z","Included","auto","No","0","3281","626432","2708","632421","0.11"
"2025-09-04T21:45:39.285Z","Included","auto","No","0","3566","1227776","852","1232194","0.17"
"2025-09-04T21:40:50.757Z","Included","auto","No","0","292","204032","861","205185","0.03"
"2025-09-04T21:36:19.472Z","Included","auto","No","0","2928","807936","3171","814035","0.14"
"2025-09-04T21:31:47.916Z","Included","auto","No","0","16844","2858880","2734","2878458","0.41"
"2025-09-04T21:29:27.394Z","Included","auto","No","0","6857","2193024","2041","2201922","0.30"
"2025-09-04T21:24:18.983Z","Included","auto","No","0","9291","1925376","5238","1939905","0.30"
"2025-09-04T21:15:47.081Z","Included","auto","No","0","719","340992","1724","343435","0.06"
"2025-09-04T21:12:30.425Z","Included","auto","No","0","13841","1473408","6340","1493589","0.26"
"2025-09-04T21:07:40.352Z","Included","auto","No","0","376","156672","1333","158381","0.03"
"2025-09-04T21:05:12.468Z","Included","auto","No","0","5420","1077120","3808","1086348","0.18"
"2025-09-04T20:48:50.630Z","Included","auto","No","0","4366","1344512","8775","1357653","0.26"
"2025-09-04T20:33:27.952Z","Errored, Not Charged","auto","No","0","122530","3925760","17868","4066158","0.82"
"2025-09-04T20:19:39.398Z","Included","auto","No","0","61888","718336","21107","801331","0.38"
"2025-09-04T20:12:11.464Z","Included","auto","No","0","8055","6400","2428","16883","0.04"
"2025-08-28T18:40:50.751Z","free","auto","No","69946","78246","693163","22573","863928","0.45"
"2025-08-28T18:27:45.065Z","Errored, Not Charged","auto","No","309789","27632","6243945","29839","6611205","1.99"
"2025-08-28T18:19:41.686Z","free","auto","No","111418","0","1660646","12379","1784443","0.58"
"2025-08-28T18:12:14.587Z","free","auto","No","36895","0","462866","12350","512111","0.20"
"2025-08-28T18:10:23.119Z","free","auto","No","6594","50204","15788","16441","89027","0.07"
"2025-08-28T18:03:04.125Z","free","auto","No","94368","36106","821961","29836","982271","0.42"
"2025-08-28T18:01:32.968Z","free","auto","No","15797","0","317004","4867","337668","0.11"
"2025-08-28T17:58:36.576Z","free","auto","No","94828","0","196084","2399","293311","0.15"
"2025-08-28T14:08:09.796Z","free","auto","No","0","594","59264","780","60638","0.02"
"2025-08-28T14:00:42.547Z","free","auto","No","0","2075","169984","1653","173712","0.04"
"2025-08-28T13:57:29.836Z","free","auto","No","0","46135","10240","1305","57680","0.07"
